# DO NOT EDIT THIS FILE MANUALLY.
# Use the CLI instead:
#
#    yarn content add-redirect <fromURL> <toURL>
#
# FROM-URL	TO-URL
/ko/docs/AJAX/Getting_Started	/ko/docs/conflicting/Web/Guide/AJAX_21419c7dfa67c94789f037a33c4e4e3e
/ko/docs/AJAX:Getting_Started	/ko/docs/conflicting/Web/Guide/AJAX_21419c7dfa67c94789f037a33c4e4e3e
/ko/docs/A_re-introduction_to_JavaScript	/ko/docs/Web/JavaScript/Language_overview
/ko/docs/About_JavaScript	/ko/docs/Web/JavaScript
/ko/docs/About_the_Document_Object_Model	/ko/docs/Web/API/Document_Object_Model
/ko/docs/Accessibility	/ko/docs/Web/Accessibility
/ko/docs/Accessibility/ARIA	/ko/docs/Web/Accessibility/ARIA
/ko/docs/Alternative_style_sheets	/ko/docs/Web/CSS/Alternative_style_sheets
/ko/docs/Apps/Progressive	/ko/docs/Web/Progressive_web_apps
/ko/docs/Apps/Progressive/App_structure	/ko/docs/Web/Progressive_web_apps/Tutorials/js13kGames/App_structure
/ko/docs/Apps/Progressive/Installable_PWAs	/ko/docs/Web/Progressive_web_apps/Tutorials/js13kGames/Installable_PWAs
/ko/docs/Apps/Progressive/Offline_Service_workers	/ko/docs/Web/Progressive_web_apps/Tutorials/js13kGames/Offline_Service_workers
/ko/docs/Apps/Progressive/Re-engageable_Notifications_Push	/ko/docs/Web/Progressive_web_apps/Tutorials/js13kGames/Re-engageable_Notifications_Push
/ko/docs/Apps/Progressive/소개	/ko/docs/Web/Progressive_web_apps/Tutorials/js13kGames
/ko/docs/CSS	/ko/docs/Web/CSS
/ko/docs/CSS/@font-face	/ko/docs/Web/CSS/@font-face
/ko/docs/CSS/Getting_Started	/en-US/docs/Learn/CSS/First_steps
/ko/docs/CSS/Getting_Started/Color	/en-US/docs/Learn/CSS/Building_blocks/Values_and_units
/ko/docs/CSS/Getting_Started/Content	/ko/docs/Learn/CSS/Howto/Generated_content
/ko/docs/CSS/Getting_Started/How_CSS_works	/en-US/docs/Learn/CSS/First_steps/How_CSS_works
/ko/docs/CSS/Getting_Started/Media	/ko/docs/Web/CSS/CSS_media_queries/Using_media_queries
/ko/docs/CSS/Getting_Started/SVG_graphics	/ko/docs/Web/SVG/Tutorial/SVG_and_CSS
/ko/docs/CSS/Getting_Started/Selectors	/en-US/docs/Learn/CSS/Building_blocks/Selectors
/ko/docs/CSS/Getting_Started/What_is_CSS	/en-US/docs/Learn/CSS/First_steps/How_CSS_works
/ko/docs/CSS/Getting_Started/Why_use_CSS	/en-US/docs/Learn/CSS/First_steps/How_CSS_works
/ko/docs/CSS/Scaling_background_images	/ko/docs/Web/CSS/CSS_backgrounds_and_borders/Resizing_background_images
/ko/docs/CSS/Understanding_z-index	/ko/docs/Web/CSS/CSS_positioned_layout/Understanding_z-index
/ko/docs/CSS/Understanding_z-index-redirect-1	/ko/docs/Web/CSS/CSS_positioned_layout/Understanding_z-index
/ko/docs/CSS/Understanding_z-index/Adding_z-index	/ko/docs/Web/CSS/CSS_positioned_layout/Understanding_z-index/Using_z-index
/ko/docs/CSS/Understanding_z-index/Stacking_and_float	/ko/docs/Web/CSS/CSS_positioned_layout/Understanding_z-index/Stacking_floating_elements
/ko/docs/CSS/Understanding_z-index/Stacking_and_float-redirect-1	/ko/docs/Web/CSS/CSS_positioned_layout/Understanding_z-index/Stacking_floating_elements
/ko/docs/CSS/Understanding_z-index/Stacking_context_example_1	/ko/docs/Web/CSS/CSS_positioned_layout/Understanding_z-index/Stacking_context_example_1
/ko/docs/CSS/Understanding_z-index/Stacking_context_example_2	/ko/docs/Web/CSS/CSS_positioned_layout/Understanding_z-index/Stacking_context_example_2
/ko/docs/CSS/Understanding_z-index/Stacking_context_example_2-redirect-1	/ko/docs/Web/CSS/CSS_positioned_layout/Understanding_z-index/Stacking_context_example_2
/ko/docs/CSS/Understanding_z-index/Stacking_context_example_3	/ko/docs/Web/CSS/CSS_positioned_layout/Understanding_z-index/Stacking_context_example_3
/ko/docs/CSS/Understanding_z-index/Stacking_without_z-index	/ko/docs/Web/CSS/CSS_positioned_layout/Understanding_z-index/Stacking_without_z-index
/ko/docs/CSS/Understanding_z-index/Stacking_without_z-index-redirect-1	/ko/docs/Web/CSS/CSS_positioned_layout/Understanding_z-index/Stacking_without_z-index
/ko/docs/CSS/Understanding_z-index/The_stacking_context	/ko/docs/Web/CSS/CSS_positioned_layout/Understanding_z-index/Stacking_context
/ko/docs/CSS/Using_CSS_animations	/ko/docs/Web/CSS/CSS_animations/Using_CSS_animations
/ko/docs/CSS/Using_CSS_transforms	/ko/docs/Web/CSS/CSS_transforms/Using_CSS_transforms
/ko/docs/CSS/animation	/ko/docs/Web/CSS/animation
/ko/docs/CSS/background	/ko/docs/Web/CSS/background
/ko/docs/CSS/background-color	/ko/docs/Web/CSS/background-color
/ko/docs/CSS/background-image	/ko/docs/Web/CSS/background-image
/ko/docs/CSS/border-radius	/ko/docs/Web/CSS/border-radius
/ko/docs/CSS/cursor	/ko/docs/Web/CSS/cursor
/ko/docs/CSS/cursor/Using_URL_values_for_the_cursor_property	/ko/docs/Web/CSS/cursor
/ko/docs/CSS/initial_value	/ko/docs/Web/CSS/initial_value
/ko/docs/CSS/transform	/ko/docs/Web/CSS/transform
/ko/docs/CSS/z-index	/ko/docs/Web/CSS/z-index
/ko/docs/CSS/시작하기	/en-US/docs/Learn/CSS/First_steps
/ko/docs/CSS/시작하기/CSS_동작_원리	/en-US/docs/Learn/CSS/First_steps/How_CSS_works
/ko/docs/CSS/시작하기/CSS란	/en-US/docs/Learn/CSS/First_steps/How_CSS_works
/ko/docs/CSS/시작하기/내용물	/ko/docs/Learn/CSS/Howto/Generated_content
/ko/docs/CSS/시작하기/미디어	/ko/docs/Web/CSS/CSS_media_queries/Using_media_queries
/ko/docs/CSS/시작하기/색상	/en-US/docs/Learn/CSS/Building_blocks/Values_and_units
/ko/docs/CSS/시작하기/설렉터	/en-US/docs/Learn/CSS/Building_blocks/Selectors
/ko/docs/CSS/시작하기/왜_CSS를_사용하나	/en-US/docs/Learn/CSS/First_steps/How_CSS_works
/ko/docs/CSS3_Columns	/ko/docs/Web/CSS/CSS_multicol_layout/Using_multicol_layouts
/ko/docs/CSS:Getting_Started	/en-US/docs/Learn/CSS/First_steps
/ko/docs/CSS:Getting_Started:Color	/en-US/docs/Learn/CSS/Building_blocks/Values_and_units
/ko/docs/CSS:Getting_Started:Content	/ko/docs/Learn/CSS/Howto/Generated_content
/ko/docs/CSS:Getting_Started:How_CSS_works	/en-US/docs/Learn/CSS/First_steps/How_CSS_works
/ko/docs/CSS:Getting_Started:Media	/ko/docs/Web/CSS/CSS_media_queries/Using_media_queries
/ko/docs/CSS:Getting_Started:SVG_graphics	/ko/docs/Web/SVG/Tutorial/SVG_and_CSS
/ko/docs/CSS:Getting_Started:Selectors	/en-US/docs/Learn/CSS/Building_blocks/Selectors
/ko/docs/CSS:Getting_Started:What_is_CSS	/en-US/docs/Learn/CSS/First_steps/How_CSS_works
/ko/docs/CSS:Getting_Started:Why_use_CSS	/en-US/docs/Learn/CSS/First_steps/How_CSS_works
/ko/docs/CSS:background	/ko/docs/Web/CSS/background
/ko/docs/CSS:initial_value	/ko/docs/Web/CSS/initial_value
/ko/docs/CSS_Reference	/ko/docs/Web/CSS/Reference
/ko/docs/Consistent_List_Indentation	/ko/docs/Web/CSS/CSS_lists/Consistent_list_indentation
/ko/docs/Core_JavaScript_1.5_Guide	/ko/docs/Web/JavaScript/Guide
/ko/docs/Core_JavaScript_1.5_Reference	/ko/docs/Web/JavaScript/Reference
/ko/docs/Core_JavaScript_1.5_Reference/About	/ko/docs/Web/JavaScript/Reference
/ko/docs/Core_JavaScript_1.5_Reference/About/Formatting_Conventions	/ko/docs/Web/JavaScript/Reference
/ko/docs/Core_JavaScript_1.5_Reference/Global_Functions	/ko/docs/Web/JavaScript/Reference/Global_Objects
/ko/docs/Core_JavaScript_1.5_Reference/Global_Objects	/ko/docs/Web/JavaScript/Reference/Global_Objects
/ko/docs/Core_JavaScript_1.5_Reference/Global_Objects/Array	/ko/docs/Web/JavaScript/Reference/Global_Objects/Array
/ko/docs/Core_JavaScript_1.5_Reference/Global_Objects/Boolean	/ko/docs/Web/JavaScript/Reference/Global_Objects/Boolean
/ko/docs/Core_JavaScript_1.5_Reference/Global_Objects/Date	/ko/docs/Web/JavaScript/Reference/Global_Objects/Date
/ko/docs/Core_JavaScript_1.5_Reference/Global_Objects/Error	/ko/docs/Web/JavaScript/Reference/Global_Objects/Error
/ko/docs/Core_JavaScript_1.5_Reference/Global_Objects/Function	/ko/docs/Web/JavaScript/Reference/Global_Objects/Function
/ko/docs/Core_JavaScript_1.5_Reference/Global_Objects/Function/call	/ko/docs/Web/JavaScript/Reference/Global_Objects/Function/call
/ko/docs/Core_JavaScript_1.5_Reference/Global_Objects/Function/prototype	/ko/docs/Web/JavaScript/Reference/Global_Objects/Function
/ko/docs/Core_JavaScript_1.5_Reference/Global_Objects/NaN	/ko/docs/Web/JavaScript/Reference/Global_Objects/NaN
/ko/docs/Core_JavaScript_1.5_Reference/Global_Objects/Object	/ko/docs/Web/JavaScript/Reference/Global_Objects/Object
/ko/docs/Core_JavaScript_1.5_Reference/Global_Objects/String	/ko/docs/Web/JavaScript/Reference/Global_Objects/String
/ko/docs/Core_JavaScript_1.5_Reference/Global_Properties	/ko/docs/Web/JavaScript/Reference/Global_Objects
/ko/docs/Core_JavaScript_1.5_Reference/Global_Properties/NaN	/ko/docs/Web/JavaScript/Reference/Global_Objects/NaN
/ko/docs/Core_JavaScript_1.5_Reference/Objects	/ko/docs/Web/JavaScript/Reference/Global_Objects
/ko/docs/Core_JavaScript_1.5_Reference/Objects/Function	/ko/docs/Web/JavaScript/Reference/Global_Objects/Function
/ko/docs/Core_JavaScript_1.5_Reference/Operators	/ko/docs/Web/JavaScript/Reference/Operators
/ko/docs/Core_JavaScript_1.5_Reference/Operators/Special_Operators	/ko/docs/Web/JavaScript/Reference/Operators
/ko/docs/Core_JavaScript_1.5_Reference/Operators/Special_Operators/this_Operator	/ko/docs/Web/JavaScript/Reference/Operators/this
/ko/docs/Core_JavaScript_1.5_Reference/Operators/this	/ko/docs/Web/JavaScript/Reference/Operators/this
/ko/docs/Core_JavaScript_1.5_Reference/Operators/void	/ko/docs/Web/JavaScript/Reference/Operators/void
/ko/docs/Core_JavaScript_1.5_Reference/Statements	/ko/docs/Web/JavaScript/Reference/Statements
/ko/docs/Core_JavaScript_1.5_Reference/Statements/for...in	/ko/docs/Web/JavaScript/Reference/Statements/for...in
/ko/docs/Core_JavaScript_1.5_Reference:About	/ko/docs/Web/JavaScript/Reference
/ko/docs/Core_JavaScript_1.5_Reference:About:Formatting_Conventions	/ko/docs/Web/JavaScript/Reference
/ko/docs/Core_JavaScript_1.5_Reference:Global_Functions	/ko/docs/Web/JavaScript/Reference/Global_Objects
/ko/docs/Core_JavaScript_1.5_Reference:Global_Objects	/ko/docs/Web/JavaScript/Reference/Global_Objects
/ko/docs/Core_JavaScript_1.5_Reference:Global_Objects:Array	/ko/docs/Web/JavaScript/Reference/Global_Objects/Array
/ko/docs/Core_JavaScript_1.5_Reference:Global_Objects:Date	/ko/docs/Web/JavaScript/Reference/Global_Objects/Date
/ko/docs/Core_JavaScript_1.5_Reference:Global_Objects:Function	/ko/docs/Web/JavaScript/Reference/Global_Objects/Function
/ko/docs/Core_JavaScript_1.5_Reference:Global_Objects:Function:prototype	/ko/docs/Web/JavaScript/Reference/Global_Objects/Function
/ko/docs/Core_JavaScript_1.5_Reference:Global_Properties	/ko/docs/Web/JavaScript/Reference/Global_Objects
/ko/docs/Core_JavaScript_1.5_Reference:Objects:Function	/ko/docs/Web/JavaScript/Reference/Global_Objects/Function
/ko/docs/Core_JavaScript_1.5_Reference:Operators:Special_Operators:this_Operator	/ko/docs/Web/JavaScript/Reference/Operators/this
/ko/docs/DOM	/ko/docs/Web/API/Document_Object_Model
/ko/docs/DOM/Notification.permission	/ko/docs/Web/API/Notification/permission_static
/ko/docs/DOM/document	/ko/docs/Web/API/Document
/ko/docs/DOM/document.activeElement	/ko/docs/Web/API/Document/activeElement
/ko/docs/DOM/document.anchors	/ko/docs/Web/API/Document/anchors
/ko/docs/DOM/document.applets	/ko/docs/Web/API/Document/applets
/ko/docs/DOM/document.body	/ko/docs/Web/API/Document/body
/ko/docs/DOM/document.createElement	/ko/docs/Web/API/Document/createElement
/ko/docs/DOM/document.createTextNode	/ko/docs/Web/API/Document/createTextNode
/ko/docs/DOM/document.getElementById	/ko/docs/Web/API/Document/getElementById
/ko/docs/DOM/document.hasFocus	/ko/docs/Web/API/Document/hasFocus
/ko/docs/DOM/element.attributes	/ko/docs/Web/API/Element/attributes
/ko/docs/DOM/element.childNodes	/ko/docs/Web/API/Node/childNodes
/ko/docs/DOM/element.firstChild	/ko/docs/Web/API/Node/firstChild
/ko/docs/DOM/element.lastChild	/ko/docs/Web/API/Node/lastChild
/ko/docs/DOM/element.length	/ko/docs/Web/API/NodeList/length
/ko/docs/DOM/element.scrollIntoView	/ko/docs/Web/API/Element/scrollIntoView
/ko/docs/DOM/event	/ko/docs/Web/API/Event
/ko/docs/DOM/event.cancelable	/ko/docs/Web/API/Event/cancelable
/ko/docs/DOM/event.preventDefault	/ko/docs/Web/API/Event/preventDefault
/ko/docs/DOM/range	/ko/docs/Web/API/Range
/ko/docs/DOM/table	/ko/docs/Web/API/HTMLTableElement
/ko/docs/DOM/table.width	/ko/docs/Web/API/HTMLTableElement/width
/ko/docs/DOM/window	/ko/docs/Web/API/Window
/ko/docs/DOM/window.getComputedStyle	/ko/docs/Web/API/Window/getComputedStyle
/ko/docs/DOM/window.navigator.geolocation.getCurrentPosition	/ko/docs/Web/API/Geolocation/getCurrentPosition
/ko/docs/DOM/window.navigator.registerProtocolHandler	/ko/docs/Web/API/Navigator/registerProtocolHandler
/ko/docs/DOM:document	/ko/docs/Web/API/Document
/ko/docs/DOM:document.activeElement	/ko/docs/Web/API/Document/activeElement
/ko/docs/DOM:document.anchors	/ko/docs/Web/API/Document/anchors
/ko/docs/DOM:document.applets	/ko/docs/Web/API/Document/applets
/ko/docs/DOM:document.body	/ko/docs/Web/API/Document/body
/ko/docs/DOM:document.createElement	/ko/docs/Web/API/Document/createElement
/ko/docs/DOM:document.createTextNode	/ko/docs/Web/API/Document/createTextNode
/ko/docs/DOM:document.getElementById	/ko/docs/Web/API/Document/getElementById
/ko/docs/DOM:document.hasFocus	/ko/docs/Web/API/Document/hasFocus
/ko/docs/DOM:element.attributes	/ko/docs/Web/API/Element/attributes
/ko/docs/DOM:element.childNodes	/ko/docs/Web/API/Node/childNodes
/ko/docs/DOM:element.firstChild	/ko/docs/Web/API/Node/firstChild
/ko/docs/DOM:element.lastChild	/ko/docs/Web/API/Node/lastChild
/ko/docs/DOM:element.length	/ko/docs/Web/API/NodeList/length
/ko/docs/DOM:event	/ko/docs/Web/API/Event
/ko/docs/DOM:range	/ko/docs/Web/API/Range
/ko/docs/DOM:table	/ko/docs/Web/API/HTMLTableElement
/ko/docs/DOM:table.width	/ko/docs/Web/API/HTMLTableElement/width
/ko/docs/DOM:window	/ko/docs/Web/API/Window
/ko/docs/DOM:window.navigator.registerProtocolHandler	/ko/docs/Web/API/Navigator/registerProtocolHandler
/ko/docs/Determining_the_dimensions_of_elements	/ko/docs/Web/API/CSS_Object_Model/Determining_the_dimensions_of_elements
/ko/docs/Drawing_Graphics_with_Canvas	/ko/docs/Web/API/Canvas_API/Tutorial
/ko/docs/Drawing_text_using_a_canvas	/ko/docs/Web/API/Canvas_API/Tutorial/Drawing_text
/ko/docs/ECMAScript	/ko/docs/Web/JavaScript
/ko/docs/EXSLT	/ko/docs/Web/EXSLT
/ko/docs/Focus_management_in_HTML	/ko/docs/Web/API/Document/hasFocus
/ko/docs/Games/Index	/ko/docs/Games
/ko/docs/Games/Tutorials/2D_breakout_game_Phaser/득점	/ko/docs/Games/Tutorials/2D_breakout_game_Phaser/The_score
/ko/docs/Games/Tutorials/순수한_자바스크립트를_이용한_2D_벽돌깨기_게임	/ko/docs/Games/Tutorials/2D_Breakout_game_pure_JavaScript
/ko/docs/Games/Tutorials/순수한_자바스크립트를_이용한_2D_벽돌깨기_게임/Bounce_off_the_walls	/ko/docs/Games/Tutorials/2D_Breakout_game_pure_JavaScript/Bounce_off_the_walls
/ko/docs/Games/Tutorials/순수한_자바스크립트를_이용한_2D_벽돌깨기_게임/Build_the_brick_field	/ko/docs/Games/Tutorials/2D_Breakout_game_pure_JavaScript/Build_the_brick_field
/ko/docs/Games/Tutorials/순수한_자바스크립트를_이용한_2D_벽돌깨기_게임/Collision_detection	/ko/docs/Games/Tutorials/2D_Breakout_game_pure_JavaScript/Collision_detection
/ko/docs/Games/Tutorials/순수한_자바스크립트를_이용한_2D_벽돌깨기_게임/Finishing_up	/ko/docs/Games/Tutorials/2D_Breakout_game_pure_JavaScript/Finishing_up
/ko/docs/Games/Tutorials/순수한_자바스크립트를_이용한_2D_벽돌깨기_게임/Game_over	/ko/docs/Games/Tutorials/2D_Breakout_game_pure_JavaScript/Game_over
/ko/docs/Games/Tutorials/순수한_자바스크립트를_이용한_2D_벽돌깨기_게임/Mouse_controls	/ko/docs/Games/Tutorials/2D_Breakout_game_pure_JavaScript/Mouse_controls
/ko/docs/Games/Tutorials/순수한_자바스크립트를_이용한_2D_벽돌깨기_게임/Paddle_and_keyboard_controls	/ko/docs/Games/Tutorials/2D_Breakout_game_pure_JavaScript/Paddle_and_keyboard_controls
/ko/docs/Games/Tutorials/순수한_자바스크립트를_이용한_2D_벽돌깨기_게임/Track_the_score_and_win	/ko/docs/Games/Tutorials/2D_Breakout_game_pure_JavaScript/Track_the_score_and_win
/ko/docs/Games/Tutorials/순수한_자바스크립트를_이용한_2D_벽돌깨기_게임/공_움직이기	/ko/docs/Games/Tutorials/2D_Breakout_game_pure_JavaScript/Move_the_ball
/ko/docs/Games/Tutorials/순수한_자바스크립트를_이용한_2D_벽돌깨기_게임/캔버스_생성과_그리기	/ko/docs/Games/Tutorials/2D_Breakout_game_pure_JavaScript/Create_the_Canvas_and_draw_on_it
/ko/docs/Glossary/Client_hints	/ko/docs/Web/HTTP/Client_hints
/ko/docs/Glossary/Descriptor_(CSS)	/ko/docs/Glossary/CSS_Descriptor
/ko/docs/Glossary/Empty_element	/ko/docs/Glossary/Void_element
/ko/docs/Glossary/Header	/ko/docs/Glossary/HTTP_header
/ko/docs/Glossary/Index	/ko/docs/Glossary
/ko/docs/Glossary/Symbol	/ko/docs/Web/JavaScript/Reference/Global_Objects/Symbol
/ko/docs/Glossary/Transmission_Control_Protocol_(TCP)	/ko/docs/Glossary/TCP
/ko/docs/Glossary/XHR_(XMLHttpRequest)	/ko/docs/Glossary/XMLHttpRequest
/ko/docs/Glossary/배열	/ko/docs/Glossary/Array
/ko/docs/Glossary/불린	/ko/docs/Glossary/Boolean
/ko/docs/Glossary/브라우저-컨텍스트	/ko/docs/Glossary/Browsing_context
/ko/docs/Glossary/스코프	/ko/docs/Glossary/Scope
/ko/docs/Glossary/식별자	/ko/docs/Glossary/Identifier
/ko/docs/Glossary/전송_제어_프로토콜_(TCP)	/ko/docs/Glossary/TCP
/ko/docs/Glossary/캐시	/ko/docs/Glossary/Cache
/ko/docs/HTML	/ko/docs/Web/HTML
/ko/docs/HTML/Block-level_elements	/ko/docs/Glossary/Block-level_content
/ko/docs/HTML/Canvas	/ko/docs/Web/API/Canvas_API
/ko/docs/HTML/Element	/ko/docs/Web/HTML/Element
/ko/docs/HTML/Element/Video	/ko/docs/Web/HTML/Element/video
/ko/docs/HTML/Element/a	/ko/docs/Web/HTML/Element/a
/ko/docs/HTML/Focus_management_in_HTML	/ko/docs/Web/API/Document/hasFocus
/ko/docs/HTML/HTML5/HTML5_element_list	/ko/docs/Web/HTML/Element
/ko/docs/HTML/HTML에서_폼	/ko/docs/Learn/Forms
/ko/docs/HTML/Inline_elements	/ko/docs/Glossary/Inline-level_content
/ko/docs/HTML/Introduction	/ko/docs/Learn/HTML/Introduction_to_HTML
/ko/docs/HTML:Canvas	/ko/docs/Web/API/Canvas_API
/ko/docs/HTML:Element	/ko/docs/Web/HTML/Element
/ko/docs/HTML:Element:a	/ko/docs/Web/HTML/Element/a
/ko/docs/HTML:Inline_elements	/ko/docs/Glossary/Inline-level_content
/ko/docs/IndexedDB	/ko/docs/Web/API/IndexedDB_API
/ko/docs/IndexedDB/Using_IndexedDB	/ko/docs/Web/API/IndexedDB_API/Using_IndexedDB
/ko/docs/Introduction_to_using_XPath_in_JavaScript	/ko/docs/Web/XPath/Introduction_to_using_XPath_in_JavaScript
/ko/docs/JavaScript	/ko/docs/Web/JavaScript
/ko/docs/JavaScript/Data_structures	/ko/docs/Web/JavaScript/Data_structures
/ko/docs/JavaScript/Guide	/ko/docs/Web/JavaScript/Guide
/ko/docs/JavaScript/Guide/About	/ko/docs/Web/JavaScript/Guide/Introduction
/ko/docs/JavaScript/Guide/Closures	/ko/docs/Web/JavaScript/Closures
/ko/docs/JavaScript/Guide/Inheritance_and_the_prototype_chain	/ko/docs/Web/JavaScript/Inheritance_and_the_prototype_chain
/ko/docs/JavaScript/Guide/Obsolete_Pages	/ko/docs/Web/JavaScript/Guide
/ko/docs/JavaScript/Guide/Obsolete_Pages/Core_JavaScript_1.5_Guide	/ko/docs/Web/JavaScript/Guide
/ko/docs/JavaScript/Guide/Values,_variables,_and_literals	/ko/docs/Web/JavaScript/Guide/Grammar_and_types
/ko/docs/JavaScript/Memory_Management	/ko/docs/Web/JavaScript/Memory_management
/ko/docs/JavaScript/Reference	/ko/docs/Web/JavaScript/Reference
/ko/docs/JavaScript/Reference/About	/ko/docs/Web/JavaScript/Reference
/ko/docs/JavaScript/Reference/About/Formatting_Conventions	/ko/docs/Web/JavaScript/Reference
/ko/docs/JavaScript/Reference/Global_Functions	/ko/docs/Web/JavaScript/Reference/Global_Objects
/ko/docs/JavaScript/Reference/Global_Objects	/ko/docs/Web/JavaScript/Reference/Global_Objects
/ko/docs/JavaScript/Reference/Global_Objects/Array	/ko/docs/Web/JavaScript/Reference/Global_Objects/Array
/ko/docs/JavaScript/Reference/Global_Objects/Boolean	/ko/docs/Web/JavaScript/Reference/Global_Objects/Boolean
/ko/docs/JavaScript/Reference/Global_Objects/Date	/ko/docs/Web/JavaScript/Reference/Global_Objects/Date
/ko/docs/JavaScript/Reference/Global_Objects/Error	/ko/docs/Web/JavaScript/Reference/Global_Objects/Error
/ko/docs/JavaScript/Reference/Global_Objects/Function	/ko/docs/Web/JavaScript/Reference/Global_Objects/Function
/ko/docs/JavaScript/Reference/Global_Objects/Function/call	/ko/docs/Web/JavaScript/Reference/Global_Objects/Function/call
/ko/docs/JavaScript/Reference/Global_Objects/Function/prototype	/ko/docs/Web/JavaScript/Reference/Global_Objects/Function
/ko/docs/JavaScript/Reference/Global_Objects/NaN	/ko/docs/Web/JavaScript/Reference/Global_Objects/NaN
/ko/docs/JavaScript/Reference/Global_Objects/Object	/ko/docs/Web/JavaScript/Reference/Global_Objects/Object
/ko/docs/JavaScript/Reference/Global_Objects/String	/ko/docs/Web/JavaScript/Reference/Global_Objects/String
/ko/docs/JavaScript/Reference/Global_Properties	/ko/docs/Web/JavaScript/Reference/Global_Objects
/ko/docs/JavaScript/Reference/Objects	/ko/docs/Web/JavaScript/Reference/Global_Objects
/ko/docs/JavaScript/Reference/Objects/Function	/ko/docs/Web/JavaScript/Reference/Global_Objects/Function
/ko/docs/JavaScript/Reference/Operators	/ko/docs/Web/JavaScript/Reference/Operators
/ko/docs/JavaScript/Reference/Operators/Special_Operators	/ko/docs/Web/JavaScript/Reference/Operators
/ko/docs/JavaScript/Reference/Operators/this	/ko/docs/Web/JavaScript/Reference/Operators/this
/ko/docs/JavaScript/Reference/Operators/void	/ko/docs/Web/JavaScript/Reference/Operators/void
/ko/docs/JavaScript/Reference/Statements	/ko/docs/Web/JavaScript/Reference/Statements
/ko/docs/JavaScript/Reference/Statements/for...in	/ko/docs/Web/JavaScript/Reference/Statements/for...in
/ko/docs/JavaScript_modules	/ko/docs/Web/JavaScript/Guide/Modules
/ko/docs/JavaScript_technologies_overview	/ko/docs/Web/JavaScript/JavaScript_technologies_overview
/ko/docs/JavaScript_technologies_overview-redirect-1	/ko/docs/Web/JavaScript/JavaScript_technologies_overview
/ko/docs/Learn/CSS/Basics	/en-US/docs/Learn/CSS/First_steps
/ko/docs/Learn/CSS/Building_blocks/상자_모델	/ko/docs/Learn/CSS/Building_blocks/The_box_model
/ko/docs/Learn/CSS/Building_blocks/선택자	/ko/docs/Learn/CSS/Building_blocks/Selectors
/ko/docs/Learn/CSS/CSS_layout/미디어_쿼리_초보자_안내서	/ko/docs/Learn/CSS/CSS_layout/Media_queries
/ko/docs/Learn/CSS/CSS_layout/반응형_디자인	/ko/docs/Learn/CSS/CSS_layout/Responsive_Design
/ko/docs/Learn/CSS/CSS_layout/위치잡기	/ko/docs/Learn/CSS/CSS_layout/Positioning
/ko/docs/Learn/CSS/CSS_layout/이전_브라우저_지원	/ko/docs/Learn/CSS/CSS_layout/Supporting_Older_Browsers
/ko/docs/Learn/CSS/CSS_layout/일반_흐름	/ko/docs/Learn/CSS/CSS_layout/Normal_Flow
/ko/docs/Learn/CSS/First_steps/Using_your_new_knowledge	/ko/docs/Learn/CSS/First_steps/Styling_a_biography_page
/ko/docs/Learn/CSS/Introduction_to_CSS	/en-US/docs/Learn/CSS/First_steps
/ko/docs/Learn/CSS/Introduction_to_CSS/Attribute_selectors	/en-US/docs/Learn/CSS/Building_blocks/Selectors/Attribute_selectors
/ko/docs/Learn/CSS/Introduction_to_CSS/Cascade_and_inheritance	/en-US/docs/Learn/CSS/Building_blocks/Cascade_and_inheritance
/ko/docs/Learn/CSS/Introduction_to_CSS/Combinators_and_multiple_selectors	/en-US/docs/Learn/CSS/Building_blocks/Selectors/Combinators
/ko/docs/Learn/CSS/Introduction_to_CSS/How_CSS_works	/en-US/docs/Learn/CSS/First_steps/How_CSS_works
/ko/docs/Learn/CSS/Introduction_to_CSS/Pseudo-classes_and_pseudo-elements	/en-US/docs/Learn/CSS/Building_blocks/Selectors/Pseudo-classes_and_pseudo-elements
/ko/docs/Learn/CSS/Introduction_to_CSS/Simple_selectors	/en-US/docs/Learn/CSS/Building_blocks/Selectors/Type_Class_and_ID_Selectors
/ko/docs/Learn/CSS/Introduction_to_CSS/Syntax	/en-US/docs/Learn/CSS/First_steps/How_CSS_is_structured
/ko/docs/Learn/CSS/Introduction_to_CSS/Values_and_units	/en-US/docs/Learn/CSS/Building_blocks/Values_and_units
/ko/docs/Learn/CSS/Introduction_to_CSS/선택자	/en-US/docs/Learn/CSS/Building_blocks/Selectors
/ko/docs/Learn/CSS/Styling_boxes	/en-US/docs/Learn/CSS/Building_blocks
/ko/docs/Learn/CSS/Styling_boxes/Backgrounds	/en-US/docs/Learn/CSS/Building_blocks/Backgrounds_and_borders
/ko/docs/Learn/Common_questions/Checking_that_your_web_site_is_working_properly	/ko/docs/Learn/Common_questions/Tools_and_setup/Checking_that_your_web_site_is_working_properly
/ko/docs/Learn/Common_questions/HTML_features_for_accessibility	/ko/docs/Learn/Common_questions/Design_and_accessibility/HTML_features_for_accessibility
/ko/docs/Learn/Common_questions/How_does_the_Internet_work	/ko/docs/Learn/Common_questions/Web_mechanics/How_does_the_Internet_work
/ko/docs/Learn/Common_questions/Pages_sites_servers_and_search_engines	/ko/docs/Learn/Common_questions/Web_mechanics/Pages_sites_servers_and_search_engines
/ko/docs/Learn/Common_questions/Thinking_before_coding	/ko/docs/Learn/Common_questions/Design_and_accessibility/Thinking_before_coding
/ko/docs/Learn/Common_questions/Upload_files_to_a_web_server	/ko/docs/Learn/Common_questions/Tools_and_setup/Upload_files_to_a_web_server
/ko/docs/Learn/Common_questions/What_are_hyperlinks	/ko/docs/Learn/Common_questions/Web_mechanics/What_are_hyperlinks
/ko/docs/Learn/Common_questions/What_is_a_URL	/ko/docs/Learn/Common_questions/Web_mechanics/What_is_a_URL
/ko/docs/Learn/Common_questions/What_is_a_web_server	/ko/docs/Learn/Common_questions/Web_mechanics/What_is_a_web_server
/ko/docs/Learn/Common_questions/What_software_do_I_need	/ko/docs/Learn/Common_questions/Tools_and_setup/What_software_do_I_need
/ko/docs/Learn/Common_questions/set_up_a_local_testing_server	/ko/docs/Learn/Common_questions/Tools_and_setup/set_up_a_local_testing_server
/ko/docs/Learn/Common_questions/웹_사이트가_제대로_동작하는지_확인	/ko/docs/Learn/Common_questions/Tools_and_setup/Checking_that_your_web_site_is_working_properly
/ko/docs/Learn/Common_questions/코딩하기_전에_생각하기	/ko/docs/Learn/Common_questions/Design_and_accessibility/Thinking_before_coding
/ko/docs/Learn/Getting_started_with_the_web/CSS_기본	/ko/docs/Learn/Getting_started_with_the_web/CSS_basics
/ko/docs/Learn/Getting_started_with_the_web/HTML_기본	/ko/docs/Learn/Getting_started_with_the_web/HTML_basics
/ko/docs/Learn/Getting_started_with_the_web/기본_소프트웨어_설치하기	/ko/docs/Learn/Getting_started_with_the_web/Installing_basic_software
/ko/docs/Learn/Getting_started_with_the_web/웹사이트_출판하기	/ko/docs/Learn/Getting_started_with_the_web/Publishing_your_website
/ko/docs/Learn/Getting_started_with_the_web/웹의_동작_방식	/ko/docs/Learn/Getting_started_with_the_web/How_the_Web_works
/ko/docs/Learn/Getting_started_with_the_web/파일들_다루기	/ko/docs/Learn/Getting_started_with_the_web/Dealing_with_files
/ko/docs/Learn/GitHub	/ko/docs/Learn/Tools_and_testing/GitHub
/ko/docs/Learn/HTML/Forms	/ko/docs/Learn/Forms
/ko/docs/Learn/HTML/Forms/HTML_폼_구성_방법	/ko/docs/Learn/Forms/How_to_structure_a_web_form
/ko/docs/Learn/HTML/Forms/My_first_HTML_form	/ko/docs/Learn/Forms/Your_first_form
/ko/docs/Learn/HTML/Forms/Your_first_HTML_form	/ko/docs/Learn/Forms/Your_first_form
/ko/docs/Learn/HTML/Howto/데이터_속성_사용하기	/ko/docs/Learn/HTML/Howto/Use_data_attributes
/ko/docs/Learn/Index	/ko/docs/Learn
/ko/docs/Learn/JavaScript/Asynchronous/Async_await	/ko/docs/Learn/JavaScript/Asynchronous/Promises
/ko/docs/Learn/JavaScript/Asynchronous/Concepts	/ko/docs/Learn/JavaScript/Asynchronous/Introducing
/ko/docs/Learn/JavaScript/Asynchronous/Timeouts_and_intervals	/ko/docs/Learn/JavaScript/Asynchronous
/ko/docs/Learn/JavaScript/Building_blocks/조건문	/ko/docs/Learn/JavaScript/Building_blocks/conditionals
/ko/docs/Learn/JavaScript/Objects/Inheritance	/ko/docs/Learn/JavaScript/Objects/Classes_in_JavaScript
/ko/docs/Learn/JavaScript/Objects/Object-oriented_JS	/ko/docs/Learn/JavaScript/Objects/Classes_in_JavaScript
/ko/docs/Learn/JavaScript/Objects/얼마나_이해했는지_확인해보자:_JSON	/ko/docs/Learn/JavaScript/Objects/Test_your_skills:_JSON
/ko/docs/Learn/Skills	/ko/docs/Learn
/ko/docs/Learn/WebGL/By_example/Clearing_by_clicking	/ko/docs/Web/API/WebGL_API/By_example/Clearing_by_clicking
/ko/docs/Learn/WebGL/By_example/Detect_WebGL	/ko/docs/Web/API/WebGL_API/By_example/Detect_WebGL
/ko/docs/Learn/WebGL/By_example/Hello_GLSL	/ko/docs/Web/API/WebGL_API/By_example/Hello_GLSL
/ko/docs/Learn/WebGL/By_example/Hello_vertex_attributes	/ko/docs/Web/API/WebGL_API/By_example/Hello_vertex_attributes
/ko/docs/Learn/WebGL/By_example/Scissor_animation	/ko/docs/Web/API/WebGL_API/By_example/Scissor_animation
/ko/docs/Learn/WebGL/By_example/Simple_color_animation	/ko/docs/Web/API/WebGL_API/By_example/Simple_color_animation
/ko/docs/Learn/WebGL/By_example/Textures_from_code	/ko/docs/Web/API/WebGL_API/By_example/Textures_from_code
/ko/docs/Learn/접근성	/ko/docs/Learn/Accessibility
/ko/docs/Learn/접근성/HTML	/ko/docs/Learn/Accessibility/HTML
/ko/docs/Learn/접근성/What_is_accessibility	/ko/docs/Learn/Accessibility/What_is_accessibility
/ko/docs/Localization	/ko/docs/Glossary/Localization
/ko/docs/MDN/About	/ko/docs/MDN/Writing_guidelines
/ko/docs/MDN/Contribute/Content/Best_practices	/ko/docs/MDN/Writing_guidelines/Experimental_deprecated_obsolete
/ko/docs/MDN/Contribute/Creating_and_editing_pages	/ko/docs/MDN/Writing_guidelines/Howto/Creating_moving_deleting
/ko/docs/MDN/Contribute/Does_this_belong	/ko/docs/MDN/Writing_guidelines/What_we_write
/ko/docs/MDN/Contribute/Feedback	/ko/docs/MDN/Community
/ko/docs/MDN/Contribute/Getting_started	/ko/docs/MDN/Community/Contributing/Getting_started
/ko/docs/MDN/Contribute/Guidelines/Code_guidelines/Code_guidelines	/ko/docs/MDN/Writing_guidelines/Writing_style_guide/Code_style_guide
/ko/docs/MDN/Contribute/Howto	/ko/docs/MDN/Contribute
/ko/docs/MDN/Contribute/Howto/Create_and_edit_pages	/ko/docs/MDN/Writing_guidelines/Howto/Creating_moving_deleting
/ko/docs/MDN/Contribute/Howto/Report_a_problem	/ko/docs/MDN/Community/Issues
/ko/docs/MDN/Getting_started	/ko/docs/MDN/Community/Contributing/Getting_started
/ko/docs/MDN/Guidelines/Best_practices	/ko/docs/MDN/Writing_guidelines/Experimental_deprecated_obsolete
/ko/docs/MDN/Guidelines/Code_guidelines/Code_guidelines	/ko/docs/MDN/Writing_guidelines/Writing_style_guide/Code_style_guide
/ko/docs/MDN/Guidelines/Code_guidelines/General	/ko/docs/MDN/Writing_guidelines/Writing_style_guide/Code_style_guide
/ko/docs/MDN/Guidelines/Conventions_definitions	/ko/docs/MDN/Writing_guidelines/Experimental_deprecated_obsolete
/ko/docs/MDN/Guidelines/Does_this_belong_on_MDN	/ko/docs/MDN/Writing_guidelines/What_we_write
/ko/docs/MDN/Kuma	https://github.com/mdn/yari/tree/main/docs
/ko/docs/MDN/Yari	https://github.com/mdn/yari/tree/main/docs
/ko/docs/MDN/피드백	/ko/docs/MDN/Community
/ko/docs/MDN_at_ten	/ko/docs/MDN/At_ten
/ko/docs/MathML	/ko/docs/Web/MathML
/ko/docs/Mozilla/Add-ons/WebExtensions/API/contextMenus	/ko/docs/Mozilla/Add-ons/WebExtensions/API/menus
/ko/docs/Mozilla/Add-ons/WebExtensions/API/contextMenus/ContextType	/ko/docs/Mozilla/Add-ons/WebExtensions/API/menus/ContextType
/ko/docs/Mozilla/Add-ons/WebExtensions/API/contextMenus/getTargetElement	/ko/docs/Mozilla/Add-ons/WebExtensions/API/menus/getTargetElement
/ko/docs/Mozilla/애드온들	/ko/docs/Mozilla/Add-ons
/ko/docs/Mozilla/애드온들/AMO/Policy/Featured	https://extensionworkshop.com/documentation/publish/recommended-extensions/
/ko/docs/Mozilla/애드온들/Listing	https://extensionworkshop.com/documentation/develop/create-an-appealing-listing/
/ko/docs/Mozilla/애드온들/WebExtensions	/ko/docs/Mozilla/Add-ons/WebExtensions
/ko/docs/Mozilla/애드온들/WebExtensions/API/contentScripts	/ko/docs/Mozilla/Add-ons/WebExtensions/API/contentScripts
/ko/docs/Mozilla/애드온들/WebExtensions/API/contextMenus	/ko/docs/Mozilla/Add-ons/WebExtensions/API/menus
/ko/docs/Mozilla/애드온들/WebExtensions/API/contextMenus/ContextType	/ko/docs/Mozilla/Add-ons/WebExtensions/API/menus/ContextType
/ko/docs/Mozilla/애드온들/WebExtensions/API/contextMenus/getTargetElement	/ko/docs/Mozilla/Add-ons/WebExtensions/API/menus/getTargetElement
/ko/docs/Mozilla/애드온들/WebExtensions/API/pageAction	/ko/docs/Mozilla/Add-ons/WebExtensions/API/pageAction
/ko/docs/Mozilla/애드온들/WebExtensions/API/pageAction/show	/ko/docs/Mozilla/Add-ons/WebExtensions/API/pageAction/show
/ko/docs/Mozilla/애드온들/WebExtensions/API/storage	/ko/docs/Mozilla/Add-ons/WebExtensions/API/storage
/ko/docs/Mozilla/애드온들/WebExtensions/API/storage/StorageArea/get	/ko/docs/Mozilla/Add-ons/WebExtensions/API/storage/StorageArea/get
/ko/docs/Mozilla/애드온들/WebExtensions/API/storage/StorageArea/set	/ko/docs/Mozilla/Add-ons/WebExtensions/API/storage/StorageArea/set
/ko/docs/Mozilla/애드온들/WebExtensions/API/storage/local	/ko/docs/Mozilla/Add-ons/WebExtensions/API/storage/local
/ko/docs/Mozilla/애드온들/WebExtensions/API/storage/sync	/ko/docs/Mozilla/Add-ons/WebExtensions/API/storage/sync
/ko/docs/Mozilla/애드온들/WebExtensions/API/tabs/create	/ko/docs/Mozilla/Add-ons/WebExtensions/API/tabs/create
/ko/docs/Mozilla/애드온들/WebExtensions/Anatomy_of_a_WebExtension	/ko/docs/Mozilla/Add-ons/WebExtensions/Anatomy_of_a_WebExtension
/ko/docs/Mozilla/애드온들/WebExtensions/Examples	/ko/docs/Mozilla/Add-ons/WebExtensions/Examples
/ko/docs/Mozilla/애드온들/WebExtensions/Package_your_extension_	https://extensionworkshop.com/documentation/publish/package-your-extension/
/ko/docs/Mozilla/애드온들/WebExtensions/Porting_a_Google_Chrome_extension	https://extensionworkshop.com/documentation/develop/porting-a-google-chrome-extension/
/ko/docs/Mozilla/애드온들/WebExtensions/Temporary_Installation_in_Firefox	https://extensionworkshop.com/documentation/develop/temporary-installation-in-firefox/
/ko/docs/Mozilla/애드온들/WebExtensions/What_are_WebExtensions	/ko/docs/Mozilla/Add-ons/WebExtensions/What_are_WebExtensions
/ko/docs/Mozilla/애드온들/WebExtensions/Your_first_WebExtension	/ko/docs/Mozilla/Add-ons/WebExtensions/Your_first_WebExtension
/ko/docs/Mozilla/애드온들/WebExtensions/Your_second_WebExtension	/ko/docs/Mozilla/Add-ons/WebExtensions/Your_second_WebExtension
/ko/docs/Mozilla/애드온들/WebExtensions/manifest.json	/ko/docs/Mozilla/Add-ons/WebExtensions/manifest.json
/ko/docs/Mozilla/애드온들/WebExtensions/user_interface/Page_actions	/ko/docs/Mozilla/Add-ons/WebExtensions/user_interface/Page_actions
/ko/docs/Mozilla_Quirks_Mode_Behavior	/ko/docs/Web/HTML/Quirks_Mode_and_Standards_Mode
/ko/docs/Navigation_timing	/ko/docs/Web/API/Performance_API/Navigation_timing
/ko/docs/Node_server_without_framework	/ko/docs/Learn/Server-side/Node_server_without_framework
/ko/docs/Online_and_offline_events	/ko/docs/Web/API/Navigator/onLine
/ko/docs/SVG	/ko/docs/Web/SVG
/ko/docs/SVG/Tutorial	/ko/docs/Web/SVG/Tutorial
/ko/docs/SVG:Tutorial	/ko/docs/Web/SVG/Tutorial
/ko/docs/SVG_In_HTML_Introduction	/ko/docs/Web/SVG/Tutorial/SVG_In_HTML_Introduction
/ko/docs/The_Importance_of_Correct_HTML_Commenting	/ko/docs/Learn/HTML/Introduction_to_HTML/Getting_started#HTML_comments
/ko/docs/The_XSLT_JavaScript_Interface_in_Gecko	/ko/docs/Web/XSLT/XSLT_JS_interface_in_Gecko
/ko/docs/The_XSLT_JavaScript_Interface_in_Gecko/Introduction	/ko/docs/Web/XSLT/XSLT_JS_interface_in_Gecko/Introduction
/ko/docs/The_XSLT_JavaScript_Interface_in_Gecko/Setting_Parameters	/ko/docs/Web/XSLT/XSLT_JS_interface_in_Gecko/Setting_Parameters
/ko/docs/The_XSLT_JavaScript_Interface_in_Gecko:Introduction	/ko/docs/Web/XSLT/XSLT_JS_interface_in_Gecko/Introduction
/ko/docs/The_XSLT_JavaScript_Interface_in_Gecko:Setting_Parameters	/ko/docs/Web/XSLT/XSLT_JS_interface_in_Gecko/Setting_Parameters
/ko/docs/Tips_for_Authoring_Fast-loading_HTML_Pages	/ko/docs/Learn/HTML/Howto/Author_fast-loading_HTML_pages
/ko/docs/Tools	https://firefox-source-docs.mozilla.org/devtools-user/index.html
/ko/docs/Tools/Accessibility_inspector	https://firefox-source-docs.mozilla.org/devtools-user/accessibility_inspector/index.html
/ko/docs/Tools/Accessibility_inspector/Simulation	https://firefox-source-docs.mozilla.org/devtools-user/accessibility_inspector/simulation/index.html
/ko/docs/Tools/Debugger	https://firefox-source-docs.mozilla.org/devtools-user/debugger/index.html
/ko/docs/Tools/Debugger/How_to	https://firefox-source-docs.mozilla.org/devtools-user/debugger/how_to/index.html
/ko/docs/Tools/Debugger/How_to/Open_the_debugger	https://firefox-source-docs.mozilla.org/devtools-user/debugger/how_to/open_the_debugger/index.html
/ko/docs/Tools/Debugger/How_to/Search	https://firefox-source-docs.mozilla.org/devtools-user/debugger/how_to/search/index.html
/ko/docs/Tools/Debugger/How_to/Set_a_breakpoint	https://firefox-source-docs.mozilla.org/devtools-user/debugger/how_to/set_a_breakpoint/index.html
/ko/docs/Tools/Debugger/UI_Tour	https://firefox-source-docs.mozilla.org/devtools-user/debugger/ui_tour/index.html
/ko/docs/Tools/How_to	https://firefox-source-docs.mozilla.org/devtools-user/debugger/how_to/index.html
/ko/docs/Tools/How_to/Open_the_debugger	https://firefox-source-docs.mozilla.org/devtools-user/debugger/how_to/open_the_debugger/index.html
/ko/docs/Tools/How_to/Search	https://firefox-source-docs.mozilla.org/devtools-user/debugger/how_to/search/index.html
/ko/docs/Tools/How_to/Set_a_breakpoint	https://firefox-source-docs.mozilla.org/devtools-user/debugger/how_to/set_a_breakpoint/index.html
/ko/docs/Tools/Network_Monitor	https://firefox-source-docs.mozilla.org/devtools-user/network_monitor/index.html
/ko/docs/Tools/Page_Inspector	https://firefox-source-docs.mozilla.org/devtools-user/page_inspector/index.html
/ko/docs/Tools/Page_Inspector/UI_Tour	https://firefox-source-docs.mozilla.org/devtools-user/page_inspector/ui_tour/index.html
/ko/docs/Tools/Performance	https://firefox-source-docs.mozilla.org/devtools-user/performance/index.html
/ko/docs/Tools/Performance/UI_Tour	https://firefox-source-docs.mozilla.org/devtools-user/performance/ui_tour/index.html
/ko/docs/Tools/Remote_Debugging	https://firefox-source-docs.mozilla.org/devtools-user/remote_debugging/index.html
/ko/docs/Tools/Remote_Debugging/Firefox_for_Android	https://firefox-source-docs.mozilla.org/devtools-user/remote_debugging/firefox_for_android/index.html
/ko/docs/Tools/Web_Console	https://firefox-source-docs.mozilla.org/devtools-user/web_console/index.html
/ko/docs/Transforming_XML_with_XSLT	/ko/docs/Web/XSLT/Transforming_XML_with_XSLT
/ko/docs/Transforming_XML_with_XSLT/The_Netscape_XSLT_XPath_Reference	/ko/docs/Web/XSLT/Transforming_XML_with_XSLT/The_Netscape_XSLT_XPath_Reference
/ko/docs/Transforming_XML_with_XSLT:The_Netscape_XSLT_XPath_Reference	/ko/docs/Web/XSLT/Transforming_XML_with_XSLT/The_Netscape_XSLT_XPath_Reference
/ko/docs/Using_JSON_in_Firefox	/ko/docs/Web/JavaScript/Reference/Global_Objects/JSON
/ko/docs/Using_URL_values_for_the_cursor_property	/ko/docs/Web/CSS/cursor
/ko/docs/Using_URL_values_for_the_cursor_property-redirect-1	/ko/docs/Web/CSS/cursor
/ko/docs/Using_the_Mozilla_JavaScript_interface_to_XSL_Transformations	/ko/docs/Web/XSLT/Using_the_Mozilla_JavaScript_interface_to_XSL_Transformations
/ko/docs/Web/API/AudioWorkletNode/onprocessorerror	/ko/docs/Web/API/AudioWorkletNode/processorerror_event
/ko/docs/Web/API/Boolean	/ko/docs/Web/JavaScript/Reference/Global_Objects/Boolean
/ko/docs/Web/API/CSSOMString	/ko/docs/Web/JavaScript/Reference/Global_Objects/String
/ko/docs/Web/API/Canvas_API/캔버스_튜토리얼	/ko/docs/Web/API/Canvas_API/Tutorial
/ko/docs/Web/API/DOMRect/fromRect	/ko/docs/Web/API/DOMRect/fromRect_static
/ko/docs/Web/API/DOMString	/ko/docs/Web/JavaScript/Reference/Global_Objects/String
/ko/docs/Web/API/Document/defaultView/popstate_event	/ko/docs/Web/API/Window/popstate_event
/ko/docs/Web/API/Document/defaultView/resize_event	/ko/docs/Web/API/Window/resize_event
/ko/docs/Web/API/Document/drag_event	/ko/docs/Web/API/HTMLElement/drag_event
/ko/docs/Web/API/Document/drag_이벤트	/ko/docs/Web/API/HTMLElement/drag_event
/ko/docs/Web/API/Document/dragend_event	/ko/docs/Web/API/HTMLElement/dragend_event
/ko/docs/Web/API/Document/dragstart_event	/ko/docs/Web/API/HTMLElement/dragstart_event
/ko/docs/Web/API/Document/keyup_event	/ko/docs/Web/API/Element/keyup_event
/ko/docs/Web/API/DocumentOrShadowRoot/activeElement	/ko/docs/Web/API/Document/activeElement
/ko/docs/Web/API/DocumentOrShadowRoot/getSelection	/ko/docs/Web/API/Document/getSelection
/ko/docs/Web/API/DocumentOrShadowRoot/styleSheets	/ko/docs/Web/API/Document/styleSheets
/ko/docs/Web/API/Document_Object_Model/Preface	/ko/docs/Web/API/Document_Object_Model
/ko/docs/Web/API/Document_Object_Model/Using_the_W3C_DOM_Level_1_Core	/ko/docs/Web/API/Document_object_model/Using_the_Document_Object_Model
/ko/docs/Web/API/Document_Object_Model/소개	/ko/docs/Web/API/Document_Object_Model/Introduction
/ko/docs/Web/API/Document_Object_Model/예제	/ko/docs/Web/API/Document_Object_Model/Examples
/ko/docs/Web/API/Element.clientHeight	/ko/docs/Web/API/Element/clientHeight
/ko/docs/Web/API/Element/accessKey	/ko/docs/Web/API/HTMLElement/accessKey
/ko/docs/Web/API/Element/childNodes	/ko/docs/Web/API/Node/childNodes
/ko/docs/Web/API/Element/firstChild	/ko/docs/Web/API/Node/firstChild
/ko/docs/Web/API/Event/createEvent	/ko/docs/Web/API/Document/createEvent
/ko/docs/Web/API/EventListener	/ko/docs/Web/API/EventTarget/addEventListener
/ko/docs/Web/API/Fetch_API/Fetch의_사용법	/ko/docs/Web/API/Fetch_API/Using_Fetch
/ko/docs/Web/API/File/Using_files_from_web_applications	/ko/docs/Web/API/File_API/Using_files_from_web_applications
/ko/docs/Web/API/File/size	/ko/docs/Web/API/Blob/size
/ko/docs/Web/API/FileReader.result	/ko/docs/Web/API/FileReader/result
/ko/docs/Web/API/GlobalEventHandlers/onchange	/ko/docs/Web/API/HTMLElement/change_event
/ko/docs/Web/API/GlobalEventHandlers/oncontextmenu	/ko/docs/Web/API/Element/contextmenu_event
/ko/docs/Web/API/GlobalEventHandlers/ondblclick	/ko/docs/Web/API/Element/dblclick_event
/ko/docs/Web/API/GlobalEventHandlers/onsubmit	/ko/docs/Web/API/HTMLFormElement/submit_event
/ko/docs/Web/API/HTMLHyperlinkElementUtils/href	/ko/docs/Web/API/HTMLAnchorElement/href
/ko/docs/Web/API/HTML_드래그_앤_드롭_API	/ko/docs/Web/API/HTML_Drag_and_Drop_API
/ko/docs/Web/API/Media_Streams_API	/ko/docs/Web/API/Media_Capture_and_Streams_API
/ko/docs/Web/API/Navigation_timing_API	/ko/docs/Web/API/Performance_API/Navigation_timing
/ko/docs/Web/API/Navigator.battery	/ko/docs/Web/API/Navigator/getBattery
/ko/docs/Web/API/Navigator.battery/window.navigator.battery	/ko/docs/Web/API/Navigator/getBattery
/ko/docs/Web/API/Navigator.connection/window.navigator.connection	/ko/docs/Web/API/Navigator/connection
/ko/docs/Web/API/Navigator/Online_and_offline_events	/ko/docs/Web/API/Navigator/onLine
/ko/docs/Web/API/Navigator/battery	/ko/docs/Web/API/Navigator/getBattery
/ko/docs/Web/API/NavigatorID	/ko/docs/Web/API/Navigator
/ko/docs/Web/API/NavigatorLanguage	/ko/docs/Web/API/Navigator
/ko/docs/Web/API/NavigatorLanguage/language	/ko/docs/Web/API/Navigator/language
/ko/docs/Web/API/NavigatorOnLine	/ko/docs/Web/API/Navigator/language
/ko/docs/Web/API/NavigatorOnLine/Online_and_offline_events	/ko/docs/Web/API/Navigator/onLine
/ko/docs/Web/API/NetworkInformation.connection	/ko/docs/Web/API/Navigator/connection
/ko/docs/Web/API/NetworkInformation.connection/window.navigator.connection	/ko/docs/Web/API/Navigator/connection
/ko/docs/Web/API/NetworkInformation/connection	/ko/docs/Web/API/Navigator/connection
/ko/docs/Web/API/Node/innerText	/ko/docs/Web/API/HTMLElement/innerText
/ko/docs/Web/API/Notification.permission	/ko/docs/Web/API/Notification/permission_static
/ko/docs/Web/API/Notification/permission	/ko/docs/Web/API/Notification/permission_static
/ko/docs/Web/API/ParentNode/childElementCount	/ko/docs/Web/API/Element/childElementCount
/ko/docs/Web/API/PhotoCapabilities	/ko/docs/Web/API/ImageCapture/getPhotoCapabilities
/ko/docs/Web/API/Position	/ko/docs/Web/API/GeolocationPosition
/ko/docs/Web/API/PositionOptions	/ko/docs/Web/API/Geolocation/getCurrentPosition
/ko/docs/Web/API/RTCConfiguration	/ko/docs/Web/API/RTCPeerConnection/RTCPeerConnection
/ko/docs/Web/API/RTCPeerConnection/generateCertificate	/ko/docs/Web/API/RTCPeerConnection/generateCertificate_static
/ko/docs/Web/API/RTCPeerConnection/onconnectionstatechange	/ko/docs/Web/API/RTCPeerConnection/connectionstatechange_event
/ko/docs/Web/API/RTCPeerConnection/ondatachannel	/ko/docs/Web/API/RTCPeerConnection/datachannel_event
/ko/docs/Web/API/RTCPeerConnection/onicecandidate	/ko/docs/Web/API/RTCPeerConnection/icecandidate_event
/ko/docs/Web/API/RTCPeerConnection/onicegatheringstatechange	/ko/docs/Web/API/RTCPeerConnection/icegatheringstatechange_event
/ko/docs/Web/API/RTCPeerConnection/ontrack	/ko/docs/Web/API/RTCPeerConnection/track_event
/ko/docs/Web/API/RandomSource	/ko/docs/Web/API/Crypto/getRandomValues
/ko/docs/Web/API/RandomSource/getRandomValues	/ko/docs/Web/API/Crypto/getRandomValues
/ko/docs/Web/API/Screen.lockOrientation	/ko/docs/Web/API/Screen/lockOrientation
/ko/docs/Web/API/Screen.lockOrientation/window.screen.lockOrientation	/ko/docs/Web/API/Screen/lockOrientation
/ko/docs/Web/API/Screen.onorientationchange	/ko/docs/Web/API/Screen/orientationchange_event
/ko/docs/Web/API/Screen.onorientationchange/window.screen.onorientationchange	/ko/docs/Web/API/Screen/orientationchange_event
/ko/docs/Web/API/Screen.orientation	/ko/docs/Web/API/Screen/orientation
/ko/docs/Web/API/Screen.orientation/window.screen.orientation	/ko/docs/Web/API/Screen/orientation
/ko/docs/Web/API/Screen/onorientationchange	/ko/docs/Web/API/Screen/orientationchange_event
/ko/docs/Web/API/ServiceWorker/onstatechange	/ko/docs/Web/API/ServiceWorker/statechange_event
/ko/docs/Web/API/URL/createObjectURL	/ko/docs/Web/API/URL/createObjectURL_static
/ko/docs/Web/API/URL/revokeObjectURL	/ko/docs/Web/API/URL/revokeObjectURL_static
/ko/docs/Web/API/USVString	/ko/docs/Web/JavaScript/Reference/Global_Objects/String
/ko/docs/Web/API/WebGL_API/Adding_2D_content_to_a_WebGL_context	/ko/docs/Web/API/WebGL_API/Tutorial/Adding_2D_content_to_a_WebGL_context
/ko/docs/Web/API/WebGL_API/Animating_objects_with_WebGL	/ko/docs/Web/API/WebGL_API/Tutorial/Animating_objects_with_WebGL
/ko/docs/Web/API/WebGL_API/Animating_textures_in_WebGL	/ko/docs/Web/API/WebGL_API/Tutorial/Animating_textures_in_WebGL
/ko/docs/Web/API/WebGL_API/Creating_3D_objects_using_WebGL	/ko/docs/Web/API/WebGL_API/Tutorial/Creating_3D_objects_using_WebGL
/ko/docs/Web/API/WebGL_API/Getting_started_with_WebGL	/ko/docs/Web/API/WebGL_API/Tutorial/Getting_started_with_WebGL
/ko/docs/Web/API/WebGL_API/Lighting_in_WebGL	/ko/docs/Web/API/WebGL_API/Tutorial/Lighting_in_WebGL
/ko/docs/Web/API/WebGL_API/Using_shaders_to_apply_color_in_WebGL	/ko/docs/Web/API/WebGL_API/Tutorial/Using_shaders_to_apply_color_in_WebGL
/ko/docs/Web/API/WebGL_API/Using_textures_in_WebGL	/ko/docs/Web/API/WebGL_API/Tutorial/Using_textures_in_WebGL
/ko/docs/Web/API/WebRTC_API/adapter.js	/ko/docs/Web/API/WebRTC_API#상호_운용성
/ko/docs/Web/API/Window/DOMContentLoaded_event	/ko/docs/Web/API/Document/DOMContentLoaded_event
/ko/docs/Web/API/Window/crypto	/ko/docs/Web/API/crypto_property
/ko/docs/Web/API/WindowEventHandlers/onhashchange	/ko/docs/Web/API/Window/hashchange_event
/ko/docs/Web/API/WindowEventHandlers/onpopstate	/ko/docs/Web/API/Window/popstate_event
/ko/docs/Web/API/WindowEventHandlers/onstorage	/ko/docs/Web/API/Window/storage_event
/ko/docs/Web/API/WindowOrWorkerGlobalScope/setTimeout	/ko/docs/Web/API/setTimeout
/ko/docs/Web/API/WindowTimers/setTimeout	/ko/docs/Web/API/setTimeout
/ko/docs/Web/API/XMLHttpRequest/timeout	/ko/docs/Web/API/XMLHttpRequest/timeout_event
/ko/docs/Web/API/document.importNode	/ko/docs/Web/API/Document/importNode
/ko/docs/Web/API/window.navigator.battery	/ko/docs/Web/API/Navigator/getBattery
/ko/docs/Web/API/window.navigator.connection	/ko/docs/Web/API/Navigator/connection
/ko/docs/Web/API/window.screen.lockOrientation	/ko/docs/Web/API/Screen/lockOrientation
/ko/docs/Web/API/window.screen.onorientationchange	/ko/docs/Web/API/Screen/orientationchange_event
/ko/docs/Web/API/window.screen.orientation	/ko/docs/Web/API/Screen/orientation
/ko/docs/Web/API/window.screen.unlockOrientation	/ko/docs/Web/API/Screen/unlockOrientation
/ko/docs/Web/Accessibility/ARIA/ARIA_Techniques/Using_the_aria-label_attribute	/ko/docs/Web/Accessibility/ARIA/Attributes/aria-label
/ko/docs/Web/Accessibility/ARIA/forms	/ko/docs/Web/Accessibility/ARIA
/ko/docs/Web/CSS/@viewport	/ko/docs/Web/CSS
/ko/docs/Web/CSS/All_About_The_Containing_Block	/ko/docs/Web/CSS/Containing_block
/ko/docs/Web/CSS/CSS_Background_and_Borders	/ko/docs/Web/CSS/CSS_backgrounds_and_borders
/ko/docs/Web/CSS/CSS_Background_and_Borders/Border-image_generator	/ko/docs/Web/CSS/CSS_backgrounds_and_borders/Border-image_generator
/ko/docs/Web/CSS/CSS_Background_and_Borders/Border-radius_generator	/ko/docs/Web/CSS/CSS_backgrounds_and_borders/Border-radius_generator
/ko/docs/Web/CSS/CSS_Backgrounds_and_Borders/Scaling_background_images	/ko/docs/Web/CSS/CSS_backgrounds_and_borders/Resizing_background_images
/ko/docs/Web/CSS/CSS_Basic_User_Interface/Using_URL_values_for_the_cursor_property	/ko/docs/Web/CSS/cursor
/ko/docs/Web/CSS/CSS_Color	/ko/docs/Web/CSS/CSS_colors
/ko/docs/Web/CSS/CSS_Columns	/ko/docs/Web/CSS/CSS_multicol_layout
/ko/docs/Web/CSS/CSS_Columns/Using_multi-column_layouts	/ko/docs/Web/CSS/CSS_multicol_layout/Using_multicol_layouts
/ko/docs/Web/CSS/CSS_Device_Adaptation	/ko/docs/Web/CSS
/ko/docs/Web/CSS/CSS_Flexible_Box_Layout/Flexbox의_기본_개념	/ko/docs/Web/CSS/CSS_flexible_box_layout/Basic_concepts_of_flexbox
/ko/docs/Web/CSS/CSS_Flexible_Box_Layout/가변상자의_대표적인_사용례	/ko/docs/Web/CSS/CSS_flexible_box_layout/Typical_use_cases_of_flexbox
/ko/docs/Web/CSS/CSS_Flow_Layout/Intro_to_formatting_contexts	/ko/docs/Web/CSS/CSS_flow_layout/Introduction_to_formatting_contexts
/ko/docs/Web/CSS/CSS_Flow_Layout/대열과_탈대열	/ko/docs/Web/CSS/CSS_flow_layout/In_flow_and_out_of_flow
/ko/docs/Web/CSS/CSS_Flow_Layout/일반_흐름_속_블록_및_인라인_레이아웃	/ko/docs/Web/CSS/CSS_flow_layout/Block_and_inline_layout_in_normal_flow
/ko/docs/Web/CSS/CSS_Flow_Layout/흐름_레이아웃과_쓰기_모드	/ko/docs/Web/CSS/CSS_flow_layout/Flow_layout_and_writing_modes
/ko/docs/Web/CSS/CSS_Flow_Layout/흐름_레이아웃과_오버플로	/ko/docs/Web/CSS/CSS_flow_layout/Flow_layout_and_overflow
/ko/docs/Web/CSS/CSS_Grid_Layout/CSS_그리드의_라인을_기준으로_한_아이템_배치	/ko/docs/Web/CSS/CSS_grid_layout/Grid_layout_using_line-based_placement
/ko/docs/Web/CSS/CSS_Grid_Layout/Layout_using_Named_Grid_Lines	/ko/docs/Web/CSS/CSS_grid_layout/Grid_layout_using_named_grid_lines
/ko/docs/Web/CSS/CSS_Grid_Layout/Line-based_Placement_with_CSS_Grid	/ko/docs/Web/CSS/CSS_grid_layout/Grid_layout_using_line-based_placement
/ko/docs/Web/CSS/CSS_Grid_Layout/Relationship_of_Grid_Layout	/ko/docs/Web/CSS/CSS_grid_layout/Relationship_of_grid_layout_with_other_layout_methods
/ko/docs/Web/CSS/CSS_Grid_Layout/그리드_레이아웃과_다른_레이아웃_방법과의_관계	/ko/docs/Web/CSS/CSS_grid_layout/Relationship_of_grid_layout_with_other_layout_methods
/ko/docs/Web/CSS/CSS_Grid_Layout/그리드_레이아웃의_기본_개념	/ko/docs/Web/CSS/CSS_grid_layout/Basic_concepts_of_grid_layout
/ko/docs/Web/CSS/CSS_Grid_Layout/그리드_템플릿_영역	/ko/docs/Web/CSS/CSS_grid_layout/Grid_template_areas
/ko/docs/Web/CSS/CSS_Grid_Layout/이름이_주어진_그리드_라인을_이용한_레이아웃	/ko/docs/Web/CSS/CSS_grid_layout/Grid_layout_using_named_grid_lines
/ko/docs/Web/CSS/CSS_Lists_and_Counters	/ko/docs/Web/CSS/CSS_lists
/ko/docs/Web/CSS/CSS_Lists_and_Counters/Consistent_list_indentation	/ko/docs/Web/CSS/CSS_lists/Consistent_list_indentation
/ko/docs/Web/CSS/CSS_Lists_and_Counters/Using_CSS_counters	/ko/docs/Web/CSS/CSS_counter_styles/Using_CSS_counters
/ko/docs/Web/CSS/CSS_Masks	/ko/docs/Web/CSS/CSS_masking
/ko/docs/Web/CSS/CSS_Pages	/ko/docs/Web/CSS/CSS_paged_media
/ko/docs/Web/CSS/CSS_Positioning	/ko/docs/Web/CSS/CSS_positioned_layout
/ko/docs/Web/CSS/CSS_Positioning/Understanding_z_index	/ko/docs/Web/CSS/CSS_positioned_layout/Understanding_z-index
/ko/docs/Web/CSS/CSS_Positioning/Understanding_z_index/Adding_z-index	/ko/docs/Web/CSS/CSS_positioned_layout/Understanding_z-index/Using_z-index
/ko/docs/Web/CSS/CSS_Positioning/Understanding_z_index/Stacking_and_float	/ko/docs/Web/CSS/CSS_positioned_layout/Understanding_z-index/Stacking_floating_elements
/ko/docs/Web/CSS/CSS_Positioning/Understanding_z_index/Stacking_context_example_1	/ko/docs/Web/CSS/CSS_positioned_layout/Understanding_z-index/Stacking_context_example_1
/ko/docs/Web/CSS/CSS_Positioning/Understanding_z_index/Stacking_context_example_2	/ko/docs/Web/CSS/CSS_positioned_layout/Understanding_z-index/Stacking_context_example_2
/ko/docs/Web/CSS/CSS_Positioning/Understanding_z_index/Stacking_context_example_3	/ko/docs/Web/CSS/CSS_positioned_layout/Understanding_z-index/Stacking_context_example_3
/ko/docs/Web/CSS/CSS_Positioning/Understanding_z_index/Stacking_without_z-index	/ko/docs/Web/CSS/CSS_positioned_layout/Understanding_z-index/Stacking_without_z-index
/ko/docs/Web/CSS/CSS_Positioning/Understanding_z_index/The_stacking_context	/ko/docs/Web/CSS/CSS_positioned_layout/Understanding_z-index/Stacking_context
/ko/docs/Web/CSS/CSS_Reference	/ko/docs/Web/CSS/Reference
/ko/docs/Web/CSS/CSS_Ruby	/ko/docs/Web/CSS/CSS_ruby_layout
/ko/docs/Web/CSS/CSS_Scroll_Snap_Points	/ko/docs/Web/CSS/CSS_scroll_snap
/ko/docs/Web/CSS/CSS_Scrollbars	/ko/docs/Web/CSS/CSS_scrollbars_styling
/ko/docs/Web/CSS/CSS_User_Interface	/ko/docs/Web/CSS/CSS_basic_user_interface
/ko/docs/Web/CSS/CSS_Variables	/ko/docs/Web/CSS/CSS_cascading_variables
/ko/docs/Web/CSS/CSS_단위와_값	/ko/docs/Web/CSS/CSS_Values_and_Units
/ko/docs/Web/CSS/Compositing_and_Blending	/ko/docs/Web/CSS/CSS_compositing_and_blending
/ko/docs/Web/CSS/Filter_Effects	/ko/docs/Web/CSS/CSS_filter_effects
/ko/docs/Web/CSS/Getting_Started	/en-US/docs/Learn/CSS/First_steps
/ko/docs/Web/CSS/Getting_Started/Color	/en-US/docs/Learn/CSS/Building_blocks/Values_and_units
/ko/docs/Web/CSS/Getting_Started/Content	/ko/docs/Learn/CSS/Howto/Generated_content
/ko/docs/Web/CSS/Getting_Started/How_CSS_works	/en-US/docs/Learn/CSS/First_steps/How_CSS_works
/ko/docs/Web/CSS/Getting_Started/Media	/ko/docs/Web/CSS/CSS_media_queries/Using_media_queries
/ko/docs/Web/CSS/Getting_Started/SVG_graphics	/ko/docs/Web/SVG/Tutorial/SVG_and_CSS
/ko/docs/Web/CSS/Getting_Started/Selectors	/en-US/docs/Learn/CSS/Building_blocks/Selectors
/ko/docs/Web/CSS/Getting_Started/What_is_CSS	/en-US/docs/Learn/CSS/First_steps/How_CSS_works
/ko/docs/Web/CSS/Getting_Started/Why_use_CSS	/en-US/docs/Learn/CSS/First_steps/How_CSS_works
/ko/docs/Web/CSS/Media_Queries	/ko/docs/Web/CSS/CSS_media_queries
/ko/docs/Web/CSS/Media_Queries/Using_Media_Queries_for_Accessibility	/ko/docs/Web/CSS/CSS_media_queries/Using_media_queries_for_accessibility
/ko/docs/Web/CSS/Media_Queries/Using_media_queries	/ko/docs/Web/CSS/CSS_media_queries/Using_media_queries
/ko/docs/Web/CSS/Scaling_background_images	/ko/docs/Web/CSS/CSS_backgrounds_and_borders/Resizing_background_images
/ko/docs/Web/CSS/Understanding_z-index	/ko/docs/Web/CSS/CSS_positioned_layout/Understanding_z-index
/ko/docs/Web/CSS/Understanding_z-index/Adding_z-index	/ko/docs/Web/CSS/CSS_positioned_layout/Understanding_z-index/Using_z-index
/ko/docs/Web/CSS/Understanding_z-index/Stacking_and_float	/ko/docs/Web/CSS/CSS_positioned_layout/Understanding_z-index/Stacking_floating_elements
/ko/docs/Web/CSS/Understanding_z-index/Stacking_context_example_1	/ko/docs/Web/CSS/CSS_positioned_layout/Understanding_z-index/Stacking_context_example_1
/ko/docs/Web/CSS/Understanding_z-index/Stacking_context_example_2	/ko/docs/Web/CSS/CSS_positioned_layout/Understanding_z-index/Stacking_context_example_2
/ko/docs/Web/CSS/Understanding_z-index/Stacking_context_example_3	/ko/docs/Web/CSS/CSS_positioned_layout/Understanding_z-index/Stacking_context_example_3
/ko/docs/Web/CSS/Understanding_z-index/Stacking_without_z-index	/ko/docs/Web/CSS/CSS_positioned_layout/Understanding_z-index/Stacking_without_z-index
/ko/docs/Web/CSS/Understanding_z-index/The_stacking_context	/ko/docs/Web/CSS/CSS_positioned_layout/Understanding_z-index/Stacking_context
/ko/docs/Web/CSS/Using_CSS_animations	/ko/docs/Web/CSS/CSS_animations/Using_CSS_animations
/ko/docs/Web/CSS/Using_CSS_transforms	/ko/docs/Web/CSS/CSS_transforms/Using_CSS_transforms
/ko/docs/Web/CSS/Using_CSS_variables	/ko/docs/Web/CSS/Using_CSS_custom_properties
/ko/docs/Web/CSS/calc()	/ko/docs/Web/CSS/calc
/ko/docs/Web/CSS/currentcolor	/ko/docs/Web/CSS/color_value#currentColor_키워드
/ko/docs/Web/CSS/cursor/Using_URL_values_for_the_cursor_property	/ko/docs/Web/CSS/cursor
/ko/docs/Web/CSS/filter-function/blur()	/ko/docs/Web/CSS/filter-function/blur
/ko/docs/Web/CSS/filter-function/brightness()	/ko/docs/Web/CSS/filter-function/brightness
/ko/docs/Web/CSS/filter-function/contrast()	/ko/docs/Web/CSS/filter-function/contrast
/ko/docs/Web/CSS/transform-function/matrix()	/ko/docs/Web/CSS/transform-function/matrix
/ko/docs/Web/CSS/transform-function/scaleX()	/ko/docs/Web/CSS/transform-function/scaleX
/ko/docs/Web/CSS/url()	/ko/docs/Web/CSS/url
/ko/docs/Web/CSS/var()	/ko/docs/Web/CSS/var
/ko/docs/Web/CSS/시작하기	/en-US/docs/Learn/CSS/First_steps
/ko/docs/Web/CSS/시작하기/CSS_동작_원리	/en-US/docs/Learn/CSS/First_steps/How_CSS_works
/ko/docs/Web/CSS/시작하기/CSS란	/en-US/docs/Learn/CSS/First_steps/How_CSS_works
/ko/docs/Web/CSS/시작하기/내용물	/ko/docs/Learn/CSS/Howto/Generated_content
/ko/docs/Web/CSS/시작하기/미디어	/ko/docs/Web/CSS/CSS_media_queries/Using_media_queries
/ko/docs/Web/CSS/시작하기/색상	/en-US/docs/Learn/CSS/Building_blocks/Values_and_units
/ko/docs/Web/CSS/시작하기/설렉터	/en-US/docs/Learn/CSS/Building_blocks/Selectors
/ko/docs/Web/CSS/시작하기/왜_CSS를_사용하나	/en-US/docs/Learn/CSS/First_steps/How_CSS_works
/ko/docs/Web/CSS/인접_형제_선택자	/ko/docs/Web/CSS/Adjacent_sibling_combinator
/ko/docs/Web/Events/DOMContentLoaded	/ko/docs/Web/API/Document/DOMContentLoaded_event
/ko/docs/Web/Events/abort	/ko/docs/Web/API/HTMLMediaElement/abort_event
/ko/docs/Web/Events/blur	/ko/docs/Web/API/Element/blur_event
/ko/docs/Web/Events/canplay	/ko/docs/Web/API/HTMLMediaElement/canplay_event
/ko/docs/Web/Events/canplaythrough	/ko/docs/Web/API/HTMLMediaElement/canplaythrough_event
/ko/docs/Web/Events/click	/ko/docs/Web/API/Element/click_event
/ko/docs/Web/Events/dragstart	/ko/docs/Web/API/HTMLElement/dragstart_event
/ko/docs/Web/Events/load	/ko/docs/Web/API/Window/load_event
/ko/docs/Web/Events/orientationchange	/ko/docs/Web/API/Window/orientationchange_event
/ko/docs/Web/Events/popstate	/ko/docs/Web/API/Window/popstate_event
/ko/docs/Web/Events/resize	/ko/docs/Web/API/Window/resize_event
/ko/docs/Web/Events/scroll	/ko/docs/Web/API/Document/scroll_event
/ko/docs/Web/Events/timeout	/ko/docs/Web/API/XMLHttpRequest/timeout_event
/ko/docs/Web/Events/visibilitychange	/ko/docs/Web/API/Document/visibilitychange_event
/ko/docs/Web/Guide/AJAX/Getting_Started	/ko/docs/conflicting/Web/Guide/AJAX_21419c7dfa67c94789f037a33c4e4e3e
/ko/docs/Web/Guide/API/Vibration/Vibration	/ko/docs/Web/API/Vibration_API
/ko/docs/Web/Guide/CSS	/ko/docs/Learn/CSS
/ko/docs/Web/Guide/CSS/Media_queries	/ko/docs/Web/CSS/CSS_media_queries/Using_media_queries
/ko/docs/Web/Guide/CSS/Using_CSS_transitions	/ko/docs/Web/CSS/CSS_transitions/Using_CSS_transitions
/ko/docs/Web/Guide/CSS/Visual_formatting_model	/ko/docs/Web/CSS/Visual_formatting_model
/ko/docs/Web/Guide/DOM/Using_full_screen_mode	/ko/docs/Web/API/Fullscreen_API
/ko/docs/Web/Guide/HTML	/ko/docs/Learn/HTML
/ko/docs/Web/Guide/HTML/Content_Editable	/ko/docs/Web/HTML/Global_attributes/contenteditable
/ko/docs/Web/Guide/HTML/Content_categories	/ko/docs/Web/HTML/Content_categories
/ko/docs/Web/Guide/HTML/Editable_content	/ko/docs/Web/HTML/Global_attributes/contenteditable
/ko/docs/Web/Guide/HTML/컨텐트_카테고리	/ko/docs/Web/HTML/Content_categories
/ko/docs/Web/Guide/HTML/폼	/ko/docs/Learn/Forms
/ko/docs/Web/Guide/HTML/폼/HTML_폼_구성_방법	/ko/docs/Learn/Forms/How_to_structure_a_web_form
/ko/docs/Web/Guide/HTML/폼/My_first_HTML_form	/ko/docs/Learn/Forms/Your_first_form
/ko/docs/Web/Guide/Index	/ko/docs/Web/Guide
/ko/docs/Web/Guide/Mobile/Separate_sites	/ko/docs/Web/Progressive_web_apps
/ko/docs/Web/Guide/XML_파싱_및_직렬화	/ko/docs/Web/Guide/Parsing_and_serializing_XML
/ko/docs/Web/Guide/그래픽	/ko/docs/Web/Guide/Graphics
/ko/docs/Web/HTML/Block-level_elements	/ko/docs/Glossary/Block-level_content
/ko/docs/Web/HTML/Canvas	/ko/docs/Web/API/Canvas_API
/ko/docs/Web/HTML/Canvas/Manipulating_video_using_canvas	/ko/docs/Web/API/Canvas_API/Manipulating_video_using_canvas
/ko/docs/Web/HTML/Canvas/Tutorial	/ko/docs/Web/API/Canvas_API/Tutorial
/ko/docs/Web/HTML/Canvas/Tutorial/Advanced_animations	/ko/docs/Web/API/Canvas_API/Tutorial/Advanced_animations
/ko/docs/Web/HTML/Canvas/Tutorial/Applying_styles_and_colors	/ko/docs/Web/API/Canvas_API/Tutorial/Applying_styles_and_colors
/ko/docs/Web/HTML/Canvas/Tutorial/Basic_animations	/ko/docs/Web/API/Canvas_API/Tutorial/Basic_animations
/ko/docs/Web/HTML/Canvas/Tutorial/Basic_usage	/ko/docs/Web/API/Canvas_API/Tutorial/Basic_usage
/ko/docs/Web/HTML/Canvas/Tutorial/Compositing	/ko/docs/Web/API/Canvas_API/Tutorial/Compositing
/ko/docs/Web/HTML/Canvas/Tutorial/Compositing/Example	/ko/docs/Web/API/Canvas_API/Tutorial/Compositing/Example
/ko/docs/Web/HTML/Canvas/Tutorial/Drawing_shapes	/ko/docs/Web/API/Canvas_API/Tutorial/Drawing_shapes
/ko/docs/Web/HTML/Canvas/Tutorial/Finale	/ko/docs/Web/API/Canvas_API/Tutorial/Finale
/ko/docs/Web/HTML/Canvas/Tutorial/Optimizing_canvas	/ko/docs/Web/API/Canvas_API/Tutorial/Optimizing_canvas
/ko/docs/Web/HTML/Canvas/Tutorial/변형	/ko/docs/Web/API/Canvas_API/Tutorial/Transformations
/ko/docs/Web/HTML/Element/Video/canplay_event	/ko/docs/Web/API/HTMLMediaElement/canplay_event
/ko/docs/Web/HTML/Element/Video/canplaythrough_event	/ko/docs/Web/API/HTMLMediaElement/canplaythrough_event
/ko/docs/Web/HTML/Element/content	/ko/docs/Web/HTML/Element/slot
/ko/docs/Web/HTML/Element/h1	/ko/docs/Web/HTML/Element/Heading_Elements
/ko/docs/Web/HTML/Element/h2	/ko/docs/Web/HTML/Element/Heading_Elements
/ko/docs/Web/HTML/Element/h3	/ko/docs/Web/HTML/Element/Heading_Elements
/ko/docs/Web/HTML/Element/h4	/ko/docs/Web/HTML/Element/Heading_Elements
/ko/docs/Web/HTML/Element/h5	/ko/docs/Web/HTML/Element/Heading_Elements
/ko/docs/Web/HTML/Element/h6	/ko/docs/Web/HTML/Element/Heading_Elements
/ko/docs/Web/HTML/Element/캔버스	/ko/docs/Web/HTML/Element/canvas
/ko/docs/Web/HTML/Focus_management_in_HTML	/ko/docs/Web/API/Document/hasFocus
/ko/docs/Web/HTML/Global_attributes/클래스	/ko/docs/Web/HTML/Global_attributes/class
/ko/docs/Web/HTML/HTML5/HTML5_element_list	/ko/docs/Web/HTML/Element
/ko/docs/Web/HTML/HTML에서_폼	/ko/docs/Learn/Forms
/ko/docs/Web/HTML/Index	/ko/docs/Web/HTML
/ko/docs/Web/HTML/Inline_elements	/ko/docs/Glossary/Inline-level_content
/ko/docs/Web/HTML/Introduction	/ko/docs/Learn/HTML/Introduction_to_HTML
/ko/docs/Web/HTML/Link_types	/ko/docs/Web/HTML/Attributes/rel
/ko/docs/Web/HTML/Link_types/preload	/ko/docs/Web/HTML/Attributes/rel/preload
/ko/docs/Web/HTTP/Access_control_CORS	/ko/docs/Web/HTTP/CORS
/ko/docs/Web/HTTP/Access_control_CORS/Errors	/ko/docs/Web/HTTP/CORS/Errors
/ko/docs/Web/HTTP/Access_control_CORS/Errors/CORSDidNotSucceed	/ko/docs/Web/HTTP/CORS/Errors/CORSDidNotSucceed
/ko/docs/Web/HTTP/Basics_of_HTTP/Data_URIs	/ko/docs/Web/HTTP/Basics_of_HTTP/Data_URLs
/ko/docs/Web/HTTP/Basics_of_HTTP/MIME_types/Complete_list_of_MIME_types	/ko/docs/Web/HTTP/Basics_of_HTTP/MIME_types/Common_types
/ko/docs/Web/HTTP/Index	/ko/docs/Web/HTTP
/ko/docs/Web/HTTP/상태_코드	/ko/docs/Web/HTTP/Status
/ko/docs/Web/JavaScript/A_re-introduction_to_JavaScript	/ko/docs/Web/JavaScript/Language_overview
/ko/docs/Web/JavaScript/About	/ko/docs/Web/JavaScript
/ko/docs/Web/JavaScript/About_JavaScript	/ko/docs/Web/JavaScript
/ko/docs/Web/JavaScript/EventLoop	/ko/docs/Web/JavaScript/Event_loop
/ko/docs/Web/JavaScript/Guide/About	/ko/docs/Web/JavaScript/Guide/Introduction
/ko/docs/Web/JavaScript/Guide/Closures	/ko/docs/Web/JavaScript/Closures
/ko/docs/Web/JavaScript/Guide/Inheritance_and_the_prototype_chain	/ko/docs/Web/JavaScript/Inheritance_and_the_prototype_chain
/ko/docs/Web/JavaScript/Guide/Obsolete_Pages	/ko/docs/Web/JavaScript/Guide
/ko/docs/Web/JavaScript/Guide/Obsolete_Pages/Core_JavaScript_1.5_Guide	/ko/docs/Web/JavaScript/Guide
/ko/docs/Web/JavaScript/Guide/Predefined_Core_Objects	/ko/docs/Web/JavaScript/Guide
/ko/docs/Web/JavaScript/Guide/Values,_variables,_and_literals	/ko/docs/Web/JavaScript/Guide/Grammar_and_types
/ko/docs/Web/JavaScript/Guide/소개	/ko/docs/Web/JavaScript/Guide/Introduction
/ko/docs/Web/JavaScript/Guide/정규식	/ko/docs/Web/JavaScript/Guide/Regular_expressions
/ko/docs/Web/JavaScript/Guide/함수	/ko/docs/Web/JavaScript/Guide/Functions
/ko/docs/Web/JavaScript/Reference/About	/ko/docs/Web/JavaScript/Reference
/ko/docs/Web/JavaScript/Reference/About/Formatting_Conventions	/ko/docs/Web/JavaScript/Reference
/ko/docs/Web/JavaScript/Reference/Classes/Class_static_initialization_blocks	/ko/docs/Web/JavaScript/Reference/Classes/Static_initialization_blocks
/ko/docs/Web/JavaScript/Reference/Errors/Bad_return_or_yield	/ko/docs/Web/JavaScript/Reference/Errors/Bad_return
/ko/docs/Web/JavaScript/Reference/Errors/Malformed_formal_parameter	/ko/docs/Web/JavaScript/Reference/Errors/Missing_formal_parameter
/ko/docs/Web/JavaScript/Reference/Errors/Not_a_codepoint	/ko/docs/Web/JavaScript/Reference/Errors/Not_a_valid_code_point
/ko/docs/Web/JavaScript/Reference/Functions/애로우_펑션	/ko/docs/Web/JavaScript/Reference/Functions/Arrow_functions
/ko/docs/Web/JavaScript/Reference/Global_Functions	/ko/docs/Web/JavaScript/Reference/Global_Objects
/ko/docs/Web/JavaScript/Reference/Global_Objects/Array/constructor	/ko/docs/Web/JavaScript/Reference/Global_Objects/Array
/ko/docs/Web/JavaScript/Reference/Global_Objects/ArrayBuffer/prototype	/ko/docs/Web/JavaScript/Reference/Global_Objects/ArrayBuffer
/ko/docs/Web/JavaScript/Reference/Global_Objects/Boolean/constructor	/ko/docs/Web/JavaScript/Reference/Global_Objects/Boolean
/ko/docs/Web/JavaScript/Reference/Global_Objects/Date/constructor	/ko/docs/Web/JavaScript/Reference/Global_Objects/Date
/ko/docs/Web/JavaScript/Reference/Global_Objects/Date/prototype	/ko/docs/Web/JavaScript/Reference/Global_Objects/Date
/ko/docs/Web/JavaScript/Reference/Global_Objects/DateTimeFormat	/ko/docs/Web/JavaScript/Reference/Global_Objects/Intl/DateTimeFormat
/ko/docs/Web/JavaScript/Reference/Global_Objects/Function/prototype	/ko/docs/Web/JavaScript/Reference/Global_Objects/Function
/ko/docs/Web/JavaScript/Reference/Global_Objects/Function/toSource	/ko/docs/Web/JavaScript/Reference/Global_Objects/Function/toString
/ko/docs/Web/JavaScript/Reference/Global_Objects/Locale/language	/ko/docs/Web/JavaScript/Reference/Global_Objects/Intl/Locale/language
/ko/docs/Web/JavaScript/Reference/Global_Objects/NumberFormat	/ko/docs/Web/JavaScript/Reference/Global_Objects/Intl/NumberFormat
/ko/docs/Web/JavaScript/Reference/Global_Objects/Proxy/handler	/ko/docs/Web/JavaScript/Reference/Global_Objects/Proxy/Proxy
/ko/docs/Web/JavaScript/Reference/Global_Objects/Proxy/handler/apply	/ko/docs/Web/JavaScript/Reference/Global_Objects/Proxy/Proxy/apply
/ko/docs/Web/JavaScript/Reference/Global_Objects/TypeError/prototype	/ko/docs/Web/JavaScript/Reference/Global_Objects/TypeError
/ko/docs/Web/JavaScript/Reference/Global_Objects/TypedArray/name	/ko/docs/Web/JavaScript/Reference/Global_Objects/Function/name
/ko/docs/Web/JavaScript/Reference/Global_Objects/WebAssembly	/ko/docs/WebAssembly/JavaScript_interface
/ko/docs/Web/JavaScript/Reference/Global_Objects/WebAssembly/CompileError	/ko/docs/WebAssembly/JavaScript_interface/CompileError
/ko/docs/Web/JavaScript/Reference/Global_Objects/WebAssembly/Global	/ko/docs/WebAssembly/JavaScript_interface/Global
/ko/docs/Web/JavaScript/Reference/Global_Objects/WebAssembly/Instance	/ko/docs/WebAssembly/JavaScript_interface/Instance
/ko/docs/Web/JavaScript/Reference/Global_Objects/WebAssembly/LinkError	/ko/docs/WebAssembly/JavaScript_interface/LinkError
/ko/docs/Web/JavaScript/Reference/Global_Objects/WebAssembly/Memory	/ko/docs/WebAssembly/JavaScript_interface/Memory
/ko/docs/Web/JavaScript/Reference/Global_Objects/WebAssembly/Module	/ko/docs/WebAssembly/JavaScript_interface/Module
/ko/docs/Web/JavaScript/Reference/Global_Objects/WebAssembly/RuntimeError	/ko/docs/WebAssembly/JavaScript_interface/RuntimeError
/ko/docs/Web/JavaScript/Reference/Global_Objects/WebAssembly/Table	/ko/docs/WebAssembly/JavaScript_interface/Table
/ko/docs/Web/JavaScript/Reference/Global_Objects/WebAssembly/compile	/ko/docs/WebAssembly/JavaScript_interface/compile
/ko/docs/Web/JavaScript/Reference/Global_Objects/WebAssembly/compileStreaming	/ko/docs/WebAssembly/JavaScript_interface/compileStreaming
/ko/docs/Web/JavaScript/Reference/Global_Objects/WebAssembly/instantiate	/ko/docs/WebAssembly/JavaScript_interface/instantiate
/ko/docs/Web/JavaScript/Reference/Global_Objects/WebAssembly/instantiateStreaming	/ko/docs/WebAssembly/JavaScript_interface/instantiateStreaming
/ko/docs/Web/JavaScript/Reference/Global_Objects/WebAssembly/validate	/ko/docs/WebAssembly/JavaScript_interface/validate
/ko/docs/Web/JavaScript/Reference/Global_Objects/null	/ko/docs/Web/JavaScript/Reference/Operators/null
/ko/docs/Web/JavaScript/Reference/Global_Properties	/ko/docs/Web/JavaScript/Reference/Global_Objects
/ko/docs/Web/JavaScript/Reference/Methods_Index	/ko/docs/Web/JavaScript/Reference
/ko/docs/Web/JavaScript/Reference/Objects	/ko/docs/Web/JavaScript/Reference/Global_Objects
/ko/docs/Web/JavaScript/Reference/Objects/Function	/ko/docs/Web/JavaScript/Reference/Global_Objects/Function
/ko/docs/Web/JavaScript/Reference/Operators/Nullish_coalescing_operator	/ko/docs/Web/JavaScript/Reference/Operators/Nullish_coalescing
/ko/docs/Web/JavaScript/Reference/Operators/Special_Operators	/ko/docs/Web/JavaScript/Reference/Operators
/ko/docs/Web/JavaScript/Reference/Operators/Spread_operator	/ko/docs/Web/JavaScript/Reference/Operators/Spread_syntax
/ko/docs/Web/JavaScript/Reference/Operators/연산자_우선순위	/ko/docs/Web/JavaScript/Reference/Operators/Operator_precedence
/ko/docs/Web/JavaScript/Reference/Properties_Index	/ko/docs/Web/JavaScript/Reference
/ko/docs/Web/JavaScript/Reference/Strict_mode/Transitioning_to_strict_mode	/ko/docs/Web/JavaScript/Reference/Strict_mode
/ko/docs/Web/JavaScript/Shells	/ko/docs/Web/JavaScript/JavaScript_technologies_overview
/ko/docs/Web/JavaScript/Tutorials	/ko/docs/Web/JavaScript
/ko/docs/Web/JavaScript/Typed_arrays	/ko/docs/Web/JavaScript/Guide/Typed_arrays
/ko/docs/Web/JavaScript/쉘	/ko/docs/Web/JavaScript/JavaScript_technologies_overview
/ko/docs/Web/Media/Formats/비디오코덱	/ko/docs/Web/Media/Formats/Video_codecs
/ko/docs/Web/Media/Formats/컨테이너	/ko/docs/Web/Media/Formats/Containers
/ko/docs/Web/Media/Formats/코덱파라미터	/ko/docs/Web/Media/Formats/codecs_parameter
/ko/docs/Web/Performance/브라우저는_어떻게_동작하는가	/ko/docs/Web/Performance/How_browsers_work
/ko/docs/Web/Performance/중요_렌더링_경로	/ko/docs/Web/Performance/Critical_rendering_path
/ko/docs/Web/Progressive_web_apps/App_structure	/ko/docs/Web/Progressive_web_apps/Tutorials/js13kGames/App_structure
/ko/docs/Web/Progressive_web_apps/Installable_PWAs	/ko/docs/Web/Progressive_web_apps/Tutorials/js13kGames/Installable_PWAs
/ko/docs/Web/Progressive_web_apps/Introduction	/ko/docs/Web/Progressive_web_apps/Tutorials/js13kGames
/ko/docs/Web/Progressive_web_apps/Offline_Service_workers	/ko/docs/Web/Progressive_web_apps/Tutorials/js13kGames/Offline_Service_workers
/ko/docs/Web/Progressive_web_apps/Re-engageable_Notifications_Push	/ko/docs/Web/Progressive_web_apps/Tutorials/js13kGames/Re-engageable_Notifications_Push
/ko/docs/Web/Progressive_web_apps/Responsive/Media_types	/ko/docs/Web/CSS/CSS_media_queries/Using_media_queries
/ko/docs/Web/Progressive_web_apps/Tutorials/js13kGames/Introduction	/ko/docs/Web/Progressive_web_apps/Tutorials/js13kGames
/ko/docs/Web/Progressive_web_apps/소개	/ko/docs/Web/Progressive_web_apps/Tutorials/js13kGames
/ko/docs/Web/Reference/Events/DOMContentLoaded	/ko/docs/Web/API/Document/DOMContentLoaded_event
/ko/docs/Web/Reference/Events/blur	/ko/docs/Web/API/Element/blur_event
/ko/docs/Web/Reference/Events/canplay	/ko/docs/Web/API/HTMLMediaElement/canplay_event
/ko/docs/Web/Reference/Events/canplaythrough	/ko/docs/Web/API/HTMLMediaElement/canplaythrough_event
/ko/docs/Web/Reference/Events/click	/ko/docs/Web/API/Element/click_event
/ko/docs/Web/Reference/Events/load	/ko/docs/Web/API/Window/load_event
/ko/docs/Web/Reference/Events/orientationchange	/ko/docs/Web/API/Window/orientationchange_event
/ko/docs/Web/Reference/Events/popstate	/ko/docs/Web/API/Window/popstate_event
/ko/docs/Web/Reference/Events/resize	/ko/docs/Web/API/Window/resize_event
/ko/docs/Web/Reference/Events/timeout	/ko/docs/Web/API/XMLHttpRequest/timeout_event
/ko/docs/Web/Reference/Events/visibilitychange	/ko/docs/Web/API/Document/visibilitychange_event
/ko/docs/Web/SVG/Element/사각형	/ko/docs/Web/SVG/Element/rect
/ko/docs/Web/SVG/Tutorial/기본_도형	/ko/docs/Web/SVG/Tutorial/Basic_Shapes
/ko/docs/Web/SVG/Tutorial/시작하기	/ko/docs/Web/SVG/Tutorial/Getting_Started
/ko/docs/Web/SVG/Tutorial/위치	/ko/docs/Web/SVG/Tutorial/Positions
/ko/docs/Web/WebGL	/ko/docs/Web/API/WebGL_API
/ko/docs/Web/WebGL/Adding_2D_content_to_a_WebGL_context	/ko/docs/Web/API/WebGL_API/Tutorial/Adding_2D_content_to_a_WebGL_context
/ko/docs/Web/WebGL/Animating_objects_with_WebGL	/ko/docs/Web/API/WebGL_API/Tutorial/Animating_objects_with_WebGL
/ko/docs/Web/WebGL/Animating_textures_in_WebGL	/ko/docs/Web/API/WebGL_API/Tutorial/Animating_textures_in_WebGL
/ko/docs/Web/WebGL/Creating_3D_objects_using_WebGL	/ko/docs/Web/API/WebGL_API/Tutorial/Creating_3D_objects_using_WebGL
/ko/docs/Web/WebGL/Getting_started_with_WebGL	/ko/docs/Web/API/WebGL_API/Tutorial/Getting_started_with_WebGL
/ko/docs/Web/WebGL/Lighting_in_WebGL	/ko/docs/Web/API/WebGL_API/Tutorial/Lighting_in_WebGL
/ko/docs/Web/WebGL/Using_shaders_to_apply_color_in_WebGL	/ko/docs/Web/API/WebGL_API/Tutorial/Using_shaders_to_apply_color_in_WebGL
/ko/docs/Web/WebGL/Using_textures_in_WebGL	/ko/docs/Web/API/WebGL_API/Tutorial/Using_textures_in_WebGL
/ko/docs/Web/Web_Components	/ko/docs/Web/API/Web_components
/ko/docs/Web/Web_Components/Custom_Elements	/ko/docs/Web/API/Web_components/Using_custom_elements
/ko/docs/Web/Web_Components/Shadow_DOM	/ko/docs/Web/API/Web_components/Using_shadow_DOM
/ko/docs/Web/Web_Components/Using_custom_elements	/ko/docs/Web/API/Web_components/Using_custom_elements
/ko/docs/Web/Web_Components/Using_shadow_DOM	/ko/docs/Web/API/Web_components/Using_shadow_DOM
/ko/docs/Web/XPath/Axes/ancestor	/ko/docs/Web/XPath/Axes#ancestor
/ko/docs/Web/XPath/Axes/ancestor-or-self	/ko/docs/Web/XPath/Axes#ancestor-or-self
/ko/docs/Web/XPath/Axes/attribute	/ko/docs/Web/XPath/Axes#attribute
/ko/docs/Web/XPath/Axes/child	/ko/docs/Web/XPath/Axes#child
/ko/docs/Web/XPath/Axes/descendant	/ko/docs/Web/XPath/Axes#descendant
/ko/docs/Web/XPath/Axes/descendant-or-self	/ko/docs/Web/XPath/Axes#descendant-or-self
/ko/docs/Web/XPath/Axes/following	/ko/docs/Web/XPath/Axes#following
/ko/docs/Web/XPath/Axes/following-sibling	/ko/docs/Web/XPath/Axes#following-sibling
/ko/docs/Web/XPath/Axes/namespace	/ko/docs/Web/XPath/Axes#namespace
/ko/docs/Web/XPath/Axes/parent	/ko/docs/Web/XPath/Axes#parent
/ko/docs/Web/XPath/Axes/preceding	/ko/docs/Web/XPath/Axes#preceding
/ko/docs/Web/XPath/Axes/preceding-sibling	/ko/docs/Web/XPath/Axes#preceding-sibling
/ko/docs/Web/XPath/Axes/self	/ko/docs/Web/XPath/Axes#self
/ko/docs/Web/XSLT/Elements	/ko/docs/Web/XSLT/Element
/ko/docs/Web/XSLT/Elements/element	/ko/docs/Web/XSLT/Element/element
/ko/docs/Web/XSLT/The_XSLT_JavaScript_Interface_in_Gecko	/ko/docs/Web/XSLT/XSLT_JS_interface_in_Gecko
/ko/docs/Web/XSLT/The_XSLT_JavaScript_Interface_in_Gecko/Introduction	/ko/docs/Web/XSLT/XSLT_JS_interface_in_Gecko/Introduction
/ko/docs/Web/XSLT/The_XSLT_JavaScript_Interface_in_Gecko/Setting_Parameters	/ko/docs/Web/XSLT/XSLT_JS_interface_in_Gecko/Setting_Parameters
/ko/docs/Web/XSLT/apply-imports	/ko/docs/Web/XSLT/Element/apply-imports
/ko/docs/Web/XSLT/apply-templates	/ko/docs/Web/XSLT/Element/apply-templates
/ko/docs/Web/XSLT/attribute	/ko/docs/Web/XSLT/Element/attribute
/ko/docs/Web/XSLT/attribute-set	/ko/docs/Web/XSLT/Element/attribute-set
/ko/docs/Web/XSLT/call-template	/ko/docs/Web/XSLT/Element/call-template
/ko/docs/Web/XSLT/choose	/ko/docs/Web/XSLT/Element/choose
/ko/docs/Web/XSLT/comment	/ko/docs/Web/XSLT/Element/comment
/ko/docs/Web/XSLT/copy	/ko/docs/Web/XSLT/Element/copy
/ko/docs/Web/XSLT/copy-of	/ko/docs/Web/XSLT/Element/copy-of
/ko/docs/Web/XSLT/decimal-format	/ko/docs/Web/XSLT/Element/decimal-format
/ko/docs/Web/XSLT/fallback	/ko/docs/Web/XSLT/Element/fallback
/ko/docs/Web/XSLT/for-each	/ko/docs/Web/XSLT/Element/for-each
/ko/docs/Web/XSLT/if	/ko/docs/Web/XSLT/Element/if
/ko/docs/Web/XSLT/import	/ko/docs/Web/XSLT/Element/import
/ko/docs/Web/XSLT/include	/ko/docs/Web/XSLT/Element/include
/ko/docs/Web/XSLT/key	/ko/docs/Web/XSLT/Element/key
/ko/docs/Web/XSLT/message	/ko/docs/Web/XSLT/Element/message
/ko/docs/Web/XSLT/namespace-alias	/ko/docs/Web/XSLT/Element/namespace-alias
/ko/docs/Web/XSLT/number	/ko/docs/Web/XSLT/Element/number
/ko/docs/Web/XSLT/otherwise	/ko/docs/Web/XSLT/Element/otherwise
/ko/docs/Web/XSLT/output	/ko/docs/Web/XSLT/Element/output
/ko/docs/Web/XSLT/param	/ko/docs/Web/XSLT/Element/param
/ko/docs/Web/XSLT/preserve-space	/ko/docs/Web/XSLT/Element/preserve-space
/ko/docs/Web/XSLT/processing-instruction	/ko/docs/Web/XSLT/Element/processing-instruction
/ko/docs/Web/XSLT/sort	/ko/docs/Web/XSLT/Element/sort
/ko/docs/Web/XSLT/strip-space	/ko/docs/Web/XSLT/Element/strip-space
/ko/docs/Web/XSLT/stylesheet	/ko/docs/Web/XSLT/Element/stylesheet
/ko/docs/Web/XSLT/template	/ko/docs/Web/XSLT/Element/template
/ko/docs/Web/XSLT/text	/ko/docs/Web/XSLT/Element/text
/ko/docs/Web/XSLT/transform	/ko/docs/Web/XSLT/Element/transform
/ko/docs/Web/XSLT/value-of	/ko/docs/Web/XSLT/Element/value-of
/ko/docs/Web/XSLT/variable	/ko/docs/Web/XSLT/Element/variable
/ko/docs/Web/XSLT/when	/ko/docs/Web/XSLT/Element/when
/ko/docs/Web/XSLT/with-param	/ko/docs/Web/XSLT/Element/with-param
/ko/docs/WebAPI/Battery_Status	/ko/docs/Web/API/Battery_Status_API
/ko/docs/WebAPI/Managing_screen_orientation	/ko/docs/Web/API/CSS_Object_Model/Managing_screen_orientation
/ko/docs/WebAPI/Network_Information	/ko/docs/Web/API/Network_Information_API
/ko/docs/WebAPI/Using_Web_Notifications	/ko/docs/Web/API/Notifications_API/Using_the_Notifications_API
/ko/docs/WebAPI/Using_geolocation	/ko/docs/Web/API/Geolocation_API/Using_the_Geolocation_API
/ko/docs/WebAPI/Vibration	/ko/docs/Web/API/Vibration_API
/ko/docs/WebAssembly/Caching_modules	/ko/docs/WebAssembly
/ko/docs/WebSockets	/ko/docs/Web/API/WebSockets_API
/ko/docs/WebSockets/Writing_WebSocket_client_applications	/ko/docs/Web/API/WebSockets_API/Writing_WebSocket_client_applications
/ko/docs/XHTML	/ko/docs/Glossary/XHTML
/ko/docs/XMLHttpRequest	/ko/docs/Web/API/XMLHttpRequest
/ko/docs/XMLHttpRequest/setRequestHeader	/ko/docs/Web/API/XMLHttpRequest/setRequestHeader
/ko/docs/XML_Introduction	/ko/docs/Web/XML/XML_introduction
/ko/docs/XPath	/ko/docs/Web/XPath
/ko/docs/XPath/Axes	/ko/docs/Web/XPath/Axes
/ko/docs/XPath/Axes/ancestor	/ko/docs/Web/XPath/Axes#ancestor
/ko/docs/XPath/Axes/ancestor-or-self	/ko/docs/Web/XPath/Axes#ancestor-or-self
/ko/docs/XPath/Axes/attribute	/ko/docs/Web/XPath/Axes#attribute
/ko/docs/XPath/Axes/child	/ko/docs/Web/XPath/Axes#child
/ko/docs/XPath/Axes/descendant	/ko/docs/Web/XPath/Axes#descendant
/ko/docs/XPath/Axes/descendant-or-self	/ko/docs/Web/XPath/Axes#descendant-or-self
/ko/docs/XPath/Axes/following	/ko/docs/Web/XPath/Axes#following
/ko/docs/XPath/Axes/following-sibling	/ko/docs/Web/XPath/Axes#following-sibling
/ko/docs/XPath/Axes/namespace	/ko/docs/Web/XPath/Axes#namespace
/ko/docs/XPath/Axes/parent	/ko/docs/Web/XPath/Axes#parent
/ko/docs/XPath/Axes/preceding	/ko/docs/Web/XPath/Axes#preceding
/ko/docs/XPath/Axes/preceding-sibling	/ko/docs/Web/XPath/Axes#preceding-sibling
/ko/docs/XPath/Axes/self	/ko/docs/Web/XPath/Axes#self
/ko/docs/XPath/Functions	/ko/docs/Web/XPath/Functions
/ko/docs/XPath/Functions/boolean	/ko/docs/Web/XPath/Functions/boolean
/ko/docs/XPath/Functions/ceiling	/ko/docs/Web/XPath/Functions/ceiling
/ko/docs/XPath/Functions/concat	/ko/docs/Web/XPath/Functions/concat
/ko/docs/XPath/Functions/contains	/ko/docs/Web/XPath/Functions/contains
/ko/docs/XPath/Functions/count	/ko/docs/Web/XPath/Functions/count
/ko/docs/XPath/Functions/document	/ko/docs/Web/XPath/Functions/document
/ko/docs/XPath/Functions/element-available	/ko/docs/Web/XPath/Functions/element-available
/ko/docs/XPath/Functions/false	/ko/docs/Web/XPath/Functions/false
/ko/docs/XPath/Functions/floor	/ko/docs/Web/XPath/Functions/floor
/ko/docs/XPath/Functions/format-number	/ko/docs/Web/XPath/Functions/format-number
/ko/docs/XPath/Functions/function-available	/ko/docs/Web/XPath/Functions/function-available
/ko/docs/XPath/Functions/generate-id	/ko/docs/Web/XPath/Functions/generate-id
/ko/docs/XPath/Functions/id	/ko/docs/Web/XPath/Functions/id
/ko/docs/XPath/Functions/key	/ko/docs/Web/XPath/Functions/key
/ko/docs/XPath/Functions/lang	/ko/docs/Web/XPath/Functions/lang
/ko/docs/XPath/Functions/last	/ko/docs/Web/XPath/Functions/last
/ko/docs/XPath/Functions/local-name	/ko/docs/Web/XPath/Functions/local-name
/ko/docs/XPath/Functions/name	/ko/docs/Web/XPath/Functions/name
/ko/docs/XPath/Functions/namespace-uri	/ko/docs/Web/XPath/Functions/namespace-uri
/ko/docs/XPath/Functions/normalize-space	/ko/docs/Web/XPath/Functions/normalize-space
/ko/docs/XPath/Functions/not	/ko/docs/Web/XPath/Functions/not
/ko/docs/XPath/Functions/number	/ko/docs/Web/XPath/Functions/number
/ko/docs/XPath/Functions/position	/ko/docs/Web/XPath/Functions/position
/ko/docs/XPath/Functions/round	/ko/docs/Web/XPath/Functions/round
/ko/docs/XPath/Functions/starts-with	/ko/docs/Web/XPath/Functions/starts-with
/ko/docs/XPath/Functions/string	/ko/docs/Web/XPath/Functions/string
/ko/docs/XPath/Functions/string-length	/ko/docs/Web/XPath/Functions/string-length
/ko/docs/XPath/Functions/substring	/ko/docs/Web/XPath/Functions/substring
/ko/docs/XPath/Functions/substring-after	/ko/docs/Web/XPath/Functions/substring-after
/ko/docs/XPath/Functions/substring-before	/ko/docs/Web/XPath/Functions/substring-before
/ko/docs/XPath/Functions/sum	/ko/docs/Web/XPath/Functions/sum
/ko/docs/XPath/Functions/system-property	/ko/docs/Web/XPath/Functions/system-property
/ko/docs/XPath/Functions/translate	/ko/docs/Web/XPath/Functions/translate
/ko/docs/XPath/Functions/true	/ko/docs/Web/XPath/Functions/true
/ko/docs/XPath/Functions/unparsed-entity-url	/ko/docs/Web/XPath/Functions/unparsed-entity-url
/ko/docs/XPath:Axes	/ko/docs/Web/XPath/Axes
/ko/docs/XPath:Axes:ancestor	/ko/docs/Web/XPath/Axes#ancestor
/ko/docs/XPath:Axes:ancestor-or-self	/ko/docs/Web/XPath/Axes#ancestor-or-self
/ko/docs/XPath:Axes:attribute	/ko/docs/Web/XPath/Axes#attribute
/ko/docs/XPath:Axes:child	/ko/docs/Web/XPath/Axes#child
/ko/docs/XPath:Axes:descendant	/ko/docs/Web/XPath/Axes#descendant
/ko/docs/XPath:Axes:descendant-or-self	/ko/docs/Web/XPath/Axes#descendant-or-self
/ko/docs/XPath:Axes:following	/ko/docs/Web/XPath/Axes#following
/ko/docs/XPath:Axes:following-sibling	/ko/docs/Web/XPath/Axes#following-sibling
/ko/docs/XPath:Axes:namespace	/ko/docs/Web/XPath/Axes#namespace
/ko/docs/XPath:Axes:parent	/ko/docs/Web/XPath/Axes#parent
/ko/docs/XPath:Axes:preceding	/ko/docs/Web/XPath/Axes#preceding
/ko/docs/XPath:Axes:preceding-sibling	/ko/docs/Web/XPath/Axes#preceding-sibling
/ko/docs/XPath:Axes:self	/ko/docs/Web/XPath/Axes#self
/ko/docs/XPath:Functions	/ko/docs/Web/XPath/Functions
/ko/docs/XPath:Functions:boolean	/ko/docs/Web/XPath/Functions/boolean
/ko/docs/XPath:Functions:ceiling	/ko/docs/Web/XPath/Functions/ceiling
/ko/docs/XPath:Functions:concat	/ko/docs/Web/XPath/Functions/concat
/ko/docs/XPath:Functions:contains	/ko/docs/Web/XPath/Functions/contains
/ko/docs/XPath:Functions:count	/ko/docs/Web/XPath/Functions/count
/ko/docs/XPath:Functions:document	/ko/docs/Web/XPath/Functions/document
/ko/docs/XPath:Functions:element-available	/ko/docs/Web/XPath/Functions/element-available
/ko/docs/XPath:Functions:false	/ko/docs/Web/XPath/Functions/false
/ko/docs/XPath:Functions:floor	/ko/docs/Web/XPath/Functions/floor
/ko/docs/XPath:Functions:format-number	/ko/docs/Web/XPath/Functions/format-number
/ko/docs/XPath:Functions:function-available	/ko/docs/Web/XPath/Functions/function-available
/ko/docs/XPath:Functions:generate-id	/ko/docs/Web/XPath/Functions/generate-id
/ko/docs/XPath:Functions:id	/ko/docs/Web/XPath/Functions/id
/ko/docs/XPath:Functions:key	/ko/docs/Web/XPath/Functions/key
/ko/docs/XPath:Functions:lang	/ko/docs/Web/XPath/Functions/lang
/ko/docs/XPath:Functions:last	/ko/docs/Web/XPath/Functions/last
/ko/docs/XPath:Functions:local-name	/ko/docs/Web/XPath/Functions/local-name
/ko/docs/XPath:Functions:name	/ko/docs/Web/XPath/Functions/name
/ko/docs/XPath:Functions:namespace-uri	/ko/docs/Web/XPath/Functions/namespace-uri
/ko/docs/XPath:Functions:normalize-space	/ko/docs/Web/XPath/Functions/normalize-space
/ko/docs/XPath:Functions:not	/ko/docs/Web/XPath/Functions/not
/ko/docs/XPath:Functions:number	/ko/docs/Web/XPath/Functions/number
/ko/docs/XPath:Functions:position	/ko/docs/Web/XPath/Functions/position
/ko/docs/XPath:Functions:round	/ko/docs/Web/XPath/Functions/round
/ko/docs/XPath:Functions:starts-with	/ko/docs/Web/XPath/Functions/starts-with
/ko/docs/XPath:Functions:string	/ko/docs/Web/XPath/Functions/string
/ko/docs/XPath:Functions:string-length	/ko/docs/Web/XPath/Functions/string-length
/ko/docs/XPath:Functions:substring	/ko/docs/Web/XPath/Functions/substring
/ko/docs/XPath:Functions:substring-after	/ko/docs/Web/XPath/Functions/substring-after
/ko/docs/XPath:Functions:substring-before	/ko/docs/Web/XPath/Functions/substring-before
/ko/docs/XPath:Functions:sum	/ko/docs/Web/XPath/Functions/sum
/ko/docs/XPath:Functions:system-property	/ko/docs/Web/XPath/Functions/system-property
/ko/docs/XPath:Functions:translate	/ko/docs/Web/XPath/Functions/translate
/ko/docs/XPath:Functions:true	/ko/docs/Web/XPath/Functions/true
/ko/docs/XPath:Functions:unparsed-entity-url	/ko/docs/Web/XPath/Functions/unparsed-entity-url
/ko/docs/XSLT	/ko/docs/Web/XSLT
/ko/docs/XSLT/Elements	/ko/docs/Web/XSLT/Element
/ko/docs/XSLT/apply-imports	/ko/docs/Web/XSLT/Element/apply-imports
/ko/docs/XSLT/apply-templates	/ko/docs/Web/XSLT/Element/apply-templates
/ko/docs/XSLT/attribute	/ko/docs/Web/XSLT/Element/attribute
/ko/docs/XSLT/attribute-set	/ko/docs/Web/XSLT/Element/attribute-set
/ko/docs/XSLT/call-template	/ko/docs/Web/XSLT/Element/call-template
/ko/docs/XSLT/choose	/ko/docs/Web/XSLT/Element/choose
/ko/docs/XSLT/comment	/ko/docs/Web/XSLT/Element/comment
/ko/docs/XSLT/copy	/ko/docs/Web/XSLT/Element/copy
/ko/docs/XSLT/copy-of	/ko/docs/Web/XSLT/Element/copy-of
/ko/docs/XSLT/decimal-format	/ko/docs/Web/XSLT/Element/decimal-format
/ko/docs/XSLT/element	/ko/docs/Web/XSLT/Element/element
/ko/docs/XSLT/fallback	/ko/docs/Web/XSLT/Element/fallback
/ko/docs/XSLT/for-each	/ko/docs/Web/XSLT/Element/for-each
/ko/docs/XSLT/if	/ko/docs/Web/XSLT/Element/if
/ko/docs/XSLT/import	/ko/docs/Web/XSLT/Element/import
/ko/docs/XSLT/include	/ko/docs/Web/XSLT/Element/include
/ko/docs/XSLT/key	/ko/docs/Web/XSLT/Element/key
/ko/docs/XSLT/message	/ko/docs/Web/XSLT/Element/message
/ko/docs/XSLT/namespace-alias	/ko/docs/Web/XSLT/Element/namespace-alias
/ko/docs/XSLT/number	/ko/docs/Web/XSLT/Element/number
/ko/docs/XSLT/otherwise	/ko/docs/Web/XSLT/Element/otherwise
/ko/docs/XSLT/output	/ko/docs/Web/XSLT/Element/output
/ko/docs/XSLT/param	/ko/docs/Web/XSLT/Element/param
/ko/docs/XSLT/preserve-space	/ko/docs/Web/XSLT/Element/preserve-space
/ko/docs/XSLT/processing-instruction	/ko/docs/Web/XSLT/Element/processing-instruction
/ko/docs/XSLT/sort	/ko/docs/Web/XSLT/Element/sort
/ko/docs/XSLT/strip-space	/ko/docs/Web/XSLT/Element/strip-space
/ko/docs/XSLT/stylesheet	/ko/docs/Web/XSLT/Element/stylesheet
/ko/docs/XSLT/template	/ko/docs/Web/XSLT/Element/template
/ko/docs/XSLT/text	/ko/docs/Web/XSLT/Element/text
/ko/docs/XSLT/transform	/ko/docs/Web/XSLT/Element/transform
/ko/docs/XSLT/value-of	/ko/docs/Web/XSLT/Element/value-of
/ko/docs/XSLT/variable	/ko/docs/Web/XSLT/Element/variable
/ko/docs/XSLT/when	/ko/docs/Web/XSLT/Element/when
/ko/docs/XSLT/with-param	/ko/docs/Web/XSLT/Element/with-param
/ko/docs/XSLT:Elements	/ko/docs/Web/XSLT/Element
/ko/docs/XSLT:apply-imports	/ko/docs/Web/XSLT/Element/apply-imports
/ko/docs/XSLT:apply-templates	/ko/docs/Web/XSLT/Element/apply-templates
/ko/docs/XSLT:attribute	/ko/docs/Web/XSLT/Element/attribute
/ko/docs/XSLT:attribute-set	/ko/docs/Web/XSLT/Element/attribute-set
/ko/docs/XSLT:call-template	/ko/docs/Web/XSLT/Element/call-template
/ko/docs/XSLT:choose	/ko/docs/Web/XSLT/Element/choose
/ko/docs/XSLT:comment	/ko/docs/Web/XSLT/Element/comment
/ko/docs/XSLT:copy	/ko/docs/Web/XSLT/Element/copy
/ko/docs/XSLT:copy-of	/ko/docs/Web/XSLT/Element/copy-of
/ko/docs/XSLT:decimal-format	/ko/docs/Web/XSLT/Element/decimal-format
/ko/docs/XSLT:element	/ko/docs/Web/XSLT/Element/element
/ko/docs/XSLT:fallback	/ko/docs/Web/XSLT/Element/fallback
/ko/docs/XSLT:for-each	/ko/docs/Web/XSLT/Element/for-each
/ko/docs/XSLT:if	/ko/docs/Web/XSLT/Element/if
/ko/docs/XSLT:import	/ko/docs/Web/XSLT/Element/import
/ko/docs/XSLT:include	/ko/docs/Web/XSLT/Element/include
/ko/docs/XSLT:key	/ko/docs/Web/XSLT/Element/key
/ko/docs/XSLT:message	/ko/docs/Web/XSLT/Element/message
/ko/docs/XSLT:namespace-alias	/ko/docs/Web/XSLT/Element/namespace-alias
/ko/docs/XSLT:number	/ko/docs/Web/XSLT/Element/number
/ko/docs/XSLT:otherwise	/ko/docs/Web/XSLT/Element/otherwise
/ko/docs/XSLT:output	/ko/docs/Web/XSLT/Element/output
/ko/docs/XSLT:param	/ko/docs/Web/XSLT/Element/param
/ko/docs/XSLT:preserve-space	/ko/docs/Web/XSLT/Element/preserve-space
/ko/docs/XSLT:processing-instruction	/ko/docs/Web/XSLT/Element/processing-instruction
/ko/docs/XSLT:sort	/ko/docs/Web/XSLT/Element/sort
/ko/docs/XSLT:strip-space	/ko/docs/Web/XSLT/Element/strip-space
/ko/docs/XSLT:stylesheet	/ko/docs/Web/XSLT/Element/stylesheet
/ko/docs/XSLT:template	/ko/docs/Web/XSLT/Element/template
/ko/docs/XSLT:text	/ko/docs/Web/XSLT/Element/text
/ko/docs/XSLT:transform	/ko/docs/Web/XSLT/Element/transform
/ko/docs/XSLT:value-of	/ko/docs/Web/XSLT/Element/value-of
/ko/docs/XSLT:variable	/ko/docs/Web/XSLT/Element/variable
/ko/docs/XSLT:when	/ko/docs/Web/XSLT/Element/when
/ko/docs/XSLT:with-param	/ko/docs/Web/XSLT/Element/with-param
/ko/docs/en	/en-US/
/ko/docs/대문	/ko/docs/Web
/ko/docs/도구들	https://firefox-source-docs.mozilla.org/devtools-user/index.html
/ko/docs/도구들/Debugger	https://firefox-source-docs.mozilla.org/devtools-user/debugger/index.html
/ko/docs/도구들/Debugger/UI_Tour	https://firefox-source-docs.mozilla.org/devtools-user/debugger/ui_tour/index.html
/ko/docs/도구들/How_to	https://firefox-source-docs.mozilla.org/devtools-user/debugger/how_to/index.html
/ko/docs/도구들/How_to/Open_the_debugger	https://firefox-source-docs.mozilla.org/devtools-user/debugger/how_to/open_the_debugger/index.html
/ko/docs/도구들/How_to/Search	https://firefox-source-docs.mozilla.org/devtools-user/debugger/how_to/search/index.html
/ko/docs/도구들/How_to/Set_a_breakpoint	https://firefox-source-docs.mozilla.org/devtools-user/debugger/how_to/set_a_breakpoint/index.html
/ko/docs/도구들/Network_Monitor	https://firefox-source-docs.mozilla.org/devtools-user/network_monitor/index.html
/ko/docs/도구들/Page_Inspector	https://firefox-source-docs.mozilla.org/devtools-user/page_inspector/index.html
/ko/docs/도구들/Page_Inspector/UI_Tour	https://firefox-source-docs.mozilla.org/devtools-user/page_inspector/ui_tour/index.html
/ko/docs/도구들/Performance	https://firefox-source-docs.mozilla.org/devtools-user/performance/index.html
/ko/docs/도구들/Performance/UI_Tour	https://firefox-source-docs.mozilla.org/devtools-user/performance/ui_tour/index.html
/ko/docs/도구들/Remote_Debugging	https://firefox-source-docs.mozilla.org/devtools-user/remote_debugging/index.html
/ko/docs/도구들/Remote_Debugging/Firefox_for_Android	https://firefox-source-docs.mozilla.org/devtools-user/remote_debugging/firefox_for_android/index.html
/ko/docs/도구들/Web_Console	https://firefox-source-docs.mozilla.org/devtools-user/web_console/index.html
/ko/docs/호환_모드와_표준_모드	/ko/docs/Web/HTML/Quirks_Mode_and_Standards_Mode
