# FROM-URL	TO-URL
/ru/docs/AJAX	/ru/docs/Web/Guide/AJAX
/ru/docs/AJAX/С_чего_начать	/ru/docs/Web/Guide/AJAX/С_чего_начать
/ru/docs/AJAX/С_чего_начать?	/ru/docs/Web/Guide/AJAX/С_чего_начать?
/ru/docs/AJAX:С_чего_начать	/ru/docs/Web/Guide/AJAX/С_чего_начать
/ru/docs/AJAX:С_чего_начать?	/ru/docs/Web/Guide/AJAX/С_чего_начать?
/ru/docs/Accessibility	/ru/docs/Web/Accessibility
/ru/docs/Accessibility/Keyboard-navigable_JavaScript_widgets	/ru/docs/Web/Accessibility/Keyboard-navigable_JavaScript_widgets
/ru/docs/Apps/Progressive	/ru/docs/Web/Progressive_web_apps
/ru/docs/Apps/Progressive/Заметный	/ru/docs/Web/Progressive_web_apps/Заметный
/ru/docs/CSS	/ru/docs/Web/CSS
/ru/docs/CSS/:active	/ru/docs/Web/CSS/:active
/ru/docs/CSS/@namespace	/ru/docs/Web/CSS/@namespace
/ru/docs/CSS/Reference	/ru/docs/Web/CSS/Reference
/ru/docs/CSS/background-attachment	/ru/docs/Web/CSS/background-attachment
/ru/docs/CSS/background-image	/ru/docs/Web/CSS/background-image
/ru/docs/CSS/background-repeat	/ru/docs/Web/CSS/background-repeat
/ru/docs/CSS/display	/ru/docs/Web/CSS/display
/ru/docs/CSS/float	/ru/docs/Web/CSS/float
/ru/docs/CSS/Синтаксис	/ru/docs/Web/CSS/Синтаксис
/ru/docs/Core_JavaScript_1.5_Reference	/ru/docs/Web/JavaScript/Reference
/ru/docs/Core_JavaScript_1.5_Reference/Functions	/ru/docs/Web/JavaScript/Guide/Functions
/ru/docs/Core_JavaScript_1.5_Reference/Global_Functions	/ru/docs/Web/JavaScript/Reference/Global_Objects
/ru/docs/Core_JavaScript_1.5_Reference/Global_Functions/String	/ru/docs/Web/JavaScript/Reference/Global_Objects/String
/ru/docs/Core_JavaScript_1.5_Reference/Global_Functions/isNaN	/ru/docs/Web/JavaScript/Reference/Global_Objects/isNaN
/ru/docs/Core_JavaScript_1.5_Reference/Global_Objects	/ru/docs/Web/JavaScript/Reference/Global_Objects
/ru/docs/Core_JavaScript_1.5_Reference/Global_Objects/Array	/ru/docs/Web/JavaScript/Reference/Global_Objects/Array
/ru/docs/Core_JavaScript_1.5_Reference/Global_Objects/Boolean	/ru/docs/Web/JavaScript/Reference/Global_Objects/Boolean
/ru/docs/Core_JavaScript_1.5_Reference/Operators	/ru/docs/Web/JavaScript/Reference/Operators
/ru/docs/Core_JavaScript_1.5_Reference/Operators/Special_Operators	/ru/docs/Web/JavaScript/Reference/Operators
/ru/docs/Core_JavaScript_1.5_Reference/Operators/Special_Operators/Оператор_typeof	/ru/docs/Web/JavaScript/Reference/Operators/typeof
/ru/docs/Core_JavaScript_1.5_Reference/Statements	/ru/docs/Web/JavaScript/Reference/Statements
/ru/docs/Core_JavaScript_1.5_Reference:Functions	/ru/docs/Web/JavaScript/Guide/Functions
/ru/docs/Core_JavaScript_1.5_Reference:Global_Functions:String	/ru/docs/Web/JavaScript/Reference/Global_Objects/String
/ru/docs/Core_JavaScript_1.5_Reference:Global_Functions:isNaN	/ru/docs/Web/JavaScript/Reference/Global_Objects/isNaN
/ru/docs/Core_JavaScript_1.5_Reference:Global_Objects	/ru/docs/Web/JavaScript/Reference/Global_Objects
/ru/docs/Core_JavaScript_1.5_Reference:Global_Objects:Array	/ru/docs/Web/JavaScript/Reference/Global_Objects/Array
/ru/docs/Core_JavaScript_1.5_Reference:Global_Objects:Boolean	/ru/docs/Web/JavaScript/Reference/Global_Objects/Boolean
/ru/docs/Creating_Custom_Firefox_Extensions_with_the_Mozilla_Build_System	/ru/docs/Создание_расширения_для_Firefox_с_использованием_Mozilla_Build_System
/ru/docs/DOM/HTMLTableElement	/ru/docs/Web/API/HTMLTableElement
/ru/docs/DOM/Node.compareDocumentPosition	/ru/docs/Web/API/Node/compareDocumentPosition
/ru/docs/DOM/Node.lastChild	/ru/docs/Web/API/Node/lastChild
/ru/docs/DOM/element	/ru/docs/Web/API/Element
/ru/docs/DOM/element.dispatchEvent	/ru/docs/Web/API/EventTarget/dispatchEvent
/ru/docs/DOM/element.getAttribute	/ru/docs/Web/API/Element/getAttribute
/ru/docs/DOM/element.onkeypress	/ru/docs/Web/API/GlobalEventHandlers/onkeypress
/ru/docs/DOM/table	/ru/docs/Web/API/HTMLTableElement
/ru/docs/DOM:document.createElement	/ru/docs/DOM/document.createElement
/ru/docs/DOM:table	/ru/docs/Web/API/HTMLTableElement
/ru/docs/Developer_Guide	/ru/docs/Mozilla/Developer_guide
/ru/docs/Developer_Guide/So_you_just_built_Firefox	/ru/docs/Mozilla/Developer_guide/So_you_just_built_Firefox
/ru/docs/Developer_Guide/mozilla-central	/ru/docs/Mozilla/Developer_guide/mozilla-central
/ru/docs/Developer_Guide/Исходный_код	/ru/docs/Mozilla/Developer_guide/Исходный_код
/ru/docs/Firefox_3_для_разработчика	/ru/docs/Firefox_3_for_developers
/ru/docs/Firefox_addons_developer_guide/Introduction_to_XUL—How_to_build_a_more_intuitive_UI-redirect-1	/ru/docs/Firefox_addons_developer_guide/Introduction_to_XUL—How_to_build_a_more_intuitive_UI
/ru/docs/Firefox_addons_developer_guide/Знакомство_с_дополнениями	/ru/docs/Firefox_addons_developer_guide/Introduction_to_Extensions
/ru/docs/Firefox_addons_developer_guide/Технологии_используемые_при_разработке_расширений	/ru/docs/Firefox_addons_developer_guide/Technologies_used_in_developing_extensions
/ru/docs/Glossary	/ru/docs/Словарь
/ru/docs/Glossary/Boolean	/ru/docs/Словарь/Boolean
/ru/docs/Glossary/Empty_element	/ru/docs/Словарь/Empty_element
/ru/docs/Glossary/JavaScript	/ru/docs/Словарь/JavaScript
/ru/docs/Glossary/Number	/ru/docs/Словарь/Number
/ru/docs/Glossary/WebSockets	/ru/docs/Словарь/WebSockets
/ru/docs/Glossary/undefined	/ru/docs/Словарь/undefined
/ru/docs/Glossary/пустой_элемент	/ru/docs/Словарь/Empty_element
/ru/docs/HTML	/ru/docs/Web/HTML
/ru/docs/HTML/Canvas	/ru/docs/Web/API/Canvas_API
/ru/docs/HTML/Canvas/Рисование_графики_с_помощью_Canvas	/ru/docs/Web/API/Canvas_API/Tutorial
/ru/docs/HTML/Element	/ru/docs/Web/HTML/Element
/ru/docs/HTML/Element/A	/ru/docs/Web/HTML/Element/A
/ru/docs/HTML/Element/abbr	/ru/docs/Web/HTML/Element/abbr
/ru/docs/HTML/Element/acronym	/ru/docs/Web/HTML/Element/acronym
/ru/docs/HTML/Element/form	/ru/docs/Web/HTML/Element/form
/ru/docs/HTML/Element/стиль	/ru/docs/Web/HTML/Element/style
/ru/docs/HTML/Optimizing_Your_Pages_for_Speculative_Parsing	/ru/docs/Web/HTML/Optimizing_Your_Pages_for_Speculative_Parsing
/ru/docs/HTML/Использование_кэширования_приложений	/ru/docs/Web/HTML/Использование_кэширования_приложений
/ru/docs/IndexedDB	/ru/docs/Web/API/IndexedDB_API
/ru/docs/IndexedDB/Basic_Concepts_Behind_IndexedDB	/ru/docs/Web/API/IndexedDB_API/Basic_Concepts_Behind_IndexedDB
/ru/docs/IndexedDB/Using_IndexedDB	/ru/docs/Web/API/IndexedDB_API/Using_IndexedDB
/ru/docs/JavaScript	/ru/docs/Web/JavaScript
/ru/docs/JavaScript/A_re-introduction_to_JavaScript	/ru/docs/Web/JavaScript/A_re-introduction_to_JavaScript
/ru/docs/JavaScript/Data_structures	/ru/docs/Web/JavaScript/Data_structures
/ru/docs/JavaScript/ECMAScript_5_support_in_Mozilla	/ru/docs/Web/JavaScript/New_in_JavaScript/ECMAScript_5_support_in_Mozilla
/ru/docs/JavaScript/Guide	/ru/docs/Web/JavaScript/Guide
/ru/docs/JavaScript/Guide/About	/ru/docs/Web/JavaScript/Guide/About
/ru/docs/JavaScript/Guide/About_ru	/ru/docs/Web/JavaScript/Guide/About
/ru/docs/JavaScript/Guide/About_ru-redirect-1	/ru/docs/Web/JavaScript/Guide/About
/ru/docs/JavaScript/Guide/Functions	/ru/docs/Web/JavaScript/Guide/Functions
/ru/docs/JavaScript/Guide/Functions-redirect-1	/ru/docs/Web/JavaScript/Guide/Functions
/ru/docs/JavaScript/Guide/LiveConnect_Overview	/ru/docs/Web/JavaScript/Guide/LiveConnect_Overview
/ru/docs/JavaScript/Guide/Regular_Expressions	/ru/docs/Web/JavaScript/Guide/Regular_Expressions
/ru/docs/JavaScript/Guide/Regular_Expressions-redirect-1	/ru/docs/Web/JavaScript/Guide/Regular_Expressions
/ru/docs/JavaScript/Guide/Statements	/ru/docs/Web/JavaScript/Guide/Control_flow_and_error_handling
/ru/docs/JavaScript/Guide/Statements-redirect-1	/ru/docs/Web/JavaScript/Guide/Control_flow_and_error_handling
/ru/docs/JavaScript/Guide/Values,_variables,_and_literals	/ru/docs/Web/JavaScript/Guide/Grammar_and_types
/ru/docs/JavaScript/Guide/Values,_variables,_and_literals-redirect-1	/ru/docs/Web/JavaScript/Guide/Grammar_and_types
/ru/docs/JavaScript/Guide/Working_with_Objects	/ru/docs/Web/JavaScript/Guide/Working_with_Objects
/ru/docs/JavaScript/Guide/Working_with_Objects-redirect-1	/ru/docs/Web/JavaScript/Guide/Working_with_Objects
/ru/docs/JavaScript/Guide/ru_JavaScript_Overview	/ru/docs/Web/JavaScript/Guide/JavaScript_Overview
/ru/docs/JavaScript/Guide/Об_этом_руководстве	/ru/docs/Web/JavaScript/Guide/Об_этом_руководстве
/ru/docs/JavaScript/Guide/Регулярные выражения	/ru/docs/Web/JavaScript/Guide/Regular_Expressions
/ru/docs/JavaScript/Guide_ru	/ru/docs/Web/JavaScript/Guide
/ru/docs/JavaScript/Guide_ru/Inheritance_and_the_prototype_chain_ru	/ru/docs/Web/JavaScript/Inheritance_and_the_prototype_chain
/ru/docs/JavaScript/Guide_ru/Замыкания	/ru/docs/Web/JavaScript/Closures
/ru/docs/JavaScript/Language_Resources	/ru/docs/Web/JavaScript/Language_Resources
/ru/docs/JavaScript/Memory_Management	/ru/docs/Web/JavaScript/Memory_Management
/ru/docs/JavaScript/New_in_JavaScript	/ru/docs/Web/JavaScript/New_in_JavaScript
/ru/docs/JavaScript/New_in_JavaScript/1.8.5	/ru/docs/Web/JavaScript/New_in_JavaScript/1.8.5
/ru/docs/JavaScript/New_in_JavaScript/Новое_в_JavaScript_1.6	/ru/docs/Web/JavaScript/New_in_JavaScript/1.6
/ru/docs/JavaScript/Reference	/ru/docs/Web/JavaScript/Reference
/ru/docs/JavaScript/Reference/Functions_and_function_scope/Strict_mode	/ru/docs/Web/JavaScript/Reference/Strict_mode
/ru/docs/JavaScript/Reference/Global_Objects	/ru/docs/Web/JavaScript/Reference/Global_Objects
/ru/docs/JavaScript/Reference/Global_Objects/Array	/ru/docs/Web/JavaScript/Reference/Global_Objects/Array
/ru/docs/JavaScript/Reference/Global_Objects/Array/every	/ru/docs/Web/JavaScript/Reference/Global_Objects/Array/every
/ru/docs/JavaScript/Reference/Global_Objects/Array/forEach	/ru/docs/Web/JavaScript/Reference/Global_Objects/Array/forEach
/ru/docs/JavaScript/Reference/Global_Objects/Array/map	/ru/docs/Web/JavaScript/Reference/Global_Objects/Array/map
/ru/docs/JavaScript/Reference/Global_Objects/Array/prototype	/ru/docs/Web/JavaScript/Reference/Global_Objects/Array/prototype
/ru/docs/JavaScript/Reference/Global_Objects/Array/some	/ru/docs/Web/JavaScript/Reference/Global_Objects/Array/some
/ru/docs/JavaScript/Reference/Global_Objects/Date	/ru/docs/Web/JavaScript/Reference/Global_Objects/Date
/ru/docs/JavaScript/Reference/Global_Objects/Date/toLocaleDateString	/ru/docs/Web/JavaScript/Reference/Global_Objects/Date/toLocaleDateString
/ru/docs/JavaScript/Reference/Global_Objects/Iterator	/ru/docs/Web/JavaScript/Reference/Global_Objects/Iterator
/ru/docs/JavaScript/Reference/Global_Objects/Math	/ru/docs/Web/JavaScript/Reference/Global_Objects/Math
/ru/docs/JavaScript/Reference/Global_Objects/Math/abs	/ru/docs/Web/JavaScript/Reference/Global_Objects/Math/abs
/ru/docs/JavaScript/Reference/Global_Objects/Math/acos	/ru/docs/Web/JavaScript/Reference/Global_Objects/Math/acos
/ru/docs/JavaScript/Reference/Global_Objects/Math/acosh	/ru/docs/Web/JavaScript/Reference/Global_Objects/Math/acosh
/ru/docs/JavaScript/Reference/Global_Objects/Math/asin	/ru/docs/Web/JavaScript/Reference/Global_Objects/Math/asin
/ru/docs/JavaScript/Reference/Global_Objects/Math/asinh	/ru/docs/Web/JavaScript/Reference/Global_Objects/Math/asinh
/ru/docs/JavaScript/Reference/Global_Objects/Math/atan	/ru/docs/Web/JavaScript/Reference/Global_Objects/Math/atan
/ru/docs/JavaScript/Reference/Global_Objects/Math/cbrt	/ru/docs/Web/JavaScript/Reference/Global_Objects/Math/cbrt
/ru/docs/JavaScript/Reference/Global_Objects/Math/hypot	/ru/docs/Web/JavaScript/Reference/Global_Objects/Math/hypot
/ru/docs/JavaScript/Reference/Global_Objects/Math/max	/ru/docs/Web/JavaScript/Reference/Global_Objects/Math/max
/ru/docs/JavaScript/Reference/Global_Objects/Math/min	/ru/docs/Web/JavaScript/Reference/Global_Objects/Math/min
/ru/docs/JavaScript/Reference/Global_Objects/Math/sign	/ru/docs/Web/JavaScript/Reference/Global_Objects/Math/sign
/ru/docs/JavaScript/Reference/Global_Objects/Math/sqrt	/ru/docs/Web/JavaScript/Reference/Global_Objects/Math/sqrt
/ru/docs/JavaScript/Reference/Global_Objects/Number	/ru/docs/Web/JavaScript/Reference/Global_Objects/Number
/ru/docs/JavaScript/Reference/Global_Objects/Object	/ru/docs/Web/JavaScript/Reference/Global_Objects/Object
/ru/docs/JavaScript/Reference/Global_Objects/Object/defineProperty	/ru/docs/Web/JavaScript/Reference/Global_Objects/Object/defineProperty
/ru/docs/JavaScript/Reference/Global_Objects/Object/getOwnPropertyDescriptor	/ru/docs/Web/JavaScript/Reference/Global_Objects/Object/getOwnPropertyDescriptor
/ru/docs/JavaScript/Reference/Global_Objects/Object/hasOwnProperty	/ru/docs/Web/JavaScript/Reference/Global_Objects/Object/hasOwnProperty
/ru/docs/JavaScript/Reference/Global_Objects/Object/is	/ru/docs/Web/JavaScript/Reference/Global_Objects/Object/is
/ru/docs/JavaScript/Reference/Global_Objects/Object/prototype	/ru/docs/Web/JavaScript/Reference/Global_Objects/Object/prototype
/ru/docs/JavaScript/Reference/Global_Objects/Object/valueOf	/ru/docs/Web/JavaScript/Reference/Global_Objects/Object/valueOf
/ru/docs/JavaScript/Reference/Global_Objects/String	/ru/docs/Web/JavaScript/Reference/Global_Objects/String
/ru/docs/JavaScript/Reference/Global_Objects/String/replace	/ru/docs/Web/JavaScript/Reference/Global_Objects/String/replace
/ru/docs/JavaScript/Reference/Operators	/ru/docs/Web/JavaScript/Reference/Operators
/ru/docs/JavaScript/Reference/Operators/Operator_Precedence	/ru/docs/Web/JavaScript/Reference/Operators/Operator_Precedence
/ru/docs/JavaScript/Reference/Operators/delete	/ru/docs/Web/JavaScript/Reference/Operators/delete
/ru/docs/JavaScript/Reference/Operators/Оператор_Запятая	/ru/docs/Web/JavaScript/Reference/Operators/Оператор_Запятая
/ru/docs/JavaScript/Reference/Statements	/ru/docs/Web/JavaScript/Reference/Statements
/ru/docs/JavaScript/Reference/Statements/let	/ru/docs/Web/JavaScript/Reference/Statements/let
/ru/docs/JavaScript_Shells	/ru/docs/Web/JavaScript/JavaScript_шеллы
/ru/docs/JavaScript_technologies_overview	/ru/docs/Web/JavaScript/JavaScript_technologies_overview
/ru/docs/JavaScript_шеллы	/ru/docs/Web/JavaScript/JavaScript_шеллы
/ru/docs/Learn/CSS/Introduction_to_CSS	/en-US/docs/Learn/CSS/First_steps
/ru/docs/Learn/CSS/Introduction_to_CSS/Attribute_selectors	/en-US/docs/Learn/CSS/Building_blocks/Selectors/Attribute_selectors
/ru/docs/Learn/CSS/Introduction_to_CSS/Box_model	/en-US/docs/Learn/CSS/Building_blocks/The_box_model
/ru/docs/Learn/CSS/Introduction_to_CSS/Cascade_and_inheritance	/en-US/docs/Learn/CSS/Building_blocks/Cascade_and_inheritance
/ru/docs/Learn/CSS/Introduction_to_CSS/Combinators_and_multiple_selectors	/en-US/docs/Learn/CSS/Building_blocks/Selectors/Combinators
/ru/docs/Learn/CSS/Introduction_to_CSS/How_CSS_works	/en-US/docs/Learn/CSS/First_steps/How_CSS_works
/ru/docs/Learn/CSS/Introduction_to_CSS/Pseudo-classes_and_pseudo-elements	/en-US/docs/Learn/CSS/Building_blocks/Selectors/Pseudo-classes_and_pseudo-elements
/ru/docs/Learn/CSS/Introduction_to_CSS/Selectors	/en-US/docs/Learn/CSS/Building_blocks/Selectors
/ru/docs/Learn/CSS/Introduction_to_CSS/Simple_selectors	/en-US/docs/Learn/CSS/Building_blocks/Selectors/Type_Class_and_ID_Selectors
/ru/docs/Learn/CSS/Introduction_to_CSS/Syntax	/en-US/docs/Learn/CSS/First_steps/How_CSS_is_structured
/ru/docs/Learn/CSS/Introduction_to_CSS/Values_and_units	/en-US/docs/Learn/CSS/Building_blocks/Values_and_units
/ru/docs/Learn/CSS/Introduction_to_CSS/Отладка_CSS	/en-US/docs/Learn/CSS/Building_blocks/Debugging_CSS
/ru/docs/Learn/CSS/Styling_boxes	/en-US/docs/Learn/CSS/Building_blocks
/ru/docs/Learn/CSS/Styling_boxes/Box_model_recap	/en-US/docs/Learn/CSS/Building_blocks/The_box_model
/ru/docs/Learn/CSS/Styling_boxes/Styling_tables	/ru/docs/Learn/CSS/Building_blocks/Styling_tables
/ru/docs/Learn/Getting_started_with_the_web/Installing_basic_software	/ru/docs/Learn/Getting_started_with_the_web/Установка_базового_программного_обеспечения
/ru/docs/Learn/Джаваскрипт	/ru/docs/Learn/JavaScript
/ru/docs/MDN/Contribute/Editor	/ru/docs/MDN/Editor
/ru/docs/MDN/Contribute/Editor/Basics	/ru/docs/MDN/Editor/Basics
/ru/docs/MDN/Contribute/Editor/Basics/Page_controls	/ru/docs/MDN/Editor/Basics/Page_controls
/ru/docs/MDN/Contribute/Editor/Basics/Toolbar	/ru/docs/MDN/Editor/Basics/Toolbar
/ru/docs/MDN/Contribute/Editor/Source_mode	/ru/docs/MDN/Editor/Source_mode
/ru/docs/MDN/Contribute/Editor/Tables	/ru/docs/MDN/Editor/Tables
/ru/docs/MDN/Contribute/Editor/Горячие_клавиши	/ru/docs/MDN/Editor/Горячие_клавиши
/ru/docs/MDN/Contribute/Editor/Картинки	/ru/docs/MDN/Editor/Картинки
/ru/docs/MDN/Contribute/Editor/Перенаправление	/ru/docs/MDN/Editor/Перенаправление
/ru/docs/MDN/Contribute/Editor/Синтаксические_выделения	/ru/docs/MDN/Editor/Синтаксические_выделения
/ru/docs/MDN/Contribute/Editor/Ссылки	/ru/docs/MDN/Editor/Ссылки
/ru/docs/MDN/Contribute/Structures	/ru/docs/MDN/Structures
/ru/docs/MDN/Contribute/Structures/Live_samples	/ru/docs/MDN/Structures/Live_samples
/ru/docs/MDN/Contribute/Structures/Live_samples/Simple_live_sample_demo	/ru/docs/MDN/Structures/Live_samples/Simple_live_sample_demo
/ru/docs/MDN/Contribute/Tools	/ru/docs/MDN/Tools
/ru/docs/MDN/Contribute/Tools/Page_watching	/ru/docs/MDN/Tools/Page_watching
/ru/docs/MDN/Feedback	/ru/docs/MDN/Contribute/Feedback
/ru/docs/MDN/Getting_started	/ru/docs/MDN/Contribute/Getting_started
/ru/docs/QA/Kak_pomoch_testirovat	/ru/docs/QA/Как_помочь_тестировать
/ru/docs/Quirks_Mode_and_Standards_Mode	/ru/docs/Web/HTML/Quirks_Mode_and_Standards_Mode
/ru/docs/SVG_In_HTML_Introduction	/ru/docs/Web/SVG/Tutorial/SVG_In_HTML_Introduction
/ru/docs/Sample_.htaccess_file	/ru/docs/Learn/Server-side/Apache_Configuration_htaccess
/ru/docs/Using_files_from_web_applications	/ru/docs/Web/API/File/Using_files_from_web_applications
/ru/docs/Web/API/AudioContext.currentTime	/ru/docs/Web/API/AudioContext/currentTime
/ru/docs/Web/API/Canvas_API/Рисование_графики_с_помощью_Canvas	/ru/docs/Web/API/Canvas_API/Tutorial
/ru/docs/Web/API/Coordinates	/ru/docs/Web/API/GeolocationCoordinates
/ru/docs/Web/API/Document.querySelectorAll	/ru/docs/Web/API/Document/querySelectorAll
/ru/docs/Web/API/Document/defaultView/popstate_event	/ru/docs/Web/API/Window/popstate_event
/ru/docs/Web/API/Document/defaultView/resize_event	/ru/docs/Web/API/Window/resize_event
/ru/docs/Web/API/Document/defaultView/storage_event	/ru/docs/Web/API/Window/storage_event
/ru/docs/Web/API/Document/domConfig	/ru/docs/Web/API/Document
/ru/docs/Web/API/Element.getBoundingClientRect	/ru/docs/Web/API/Element/getBoundingClientRect
/ru/docs/Web/API/Element.insertAdjacentHTML	/ru/docs/Web/API/Element/insertAdjacentHTML
/ru/docs/Web/API/EventTarget.addEventListener	/ru/docs/Web/API/EventTarget/addEventListener
/ru/docs/Web/API/HTMLElement/invalid	/ru/docs/Web/API/HTMLInputElement/invalid_event
/ru/docs/Web/API/HTMLImageElement.Image	/ru/docs/Web/API/HTMLImageElement/Image
/ru/docs/Web/API/Node.appendChild	/ru/docs/Web/API/Node/appendChild
/ru/docs/Web/API/Node.contains	/ru/docs/Web/API/Node/contains
/ru/docs/Web/API/Node.parentNode	/ru/docs/Web/API/Node/parentNode
/ru/docs/Web/API/Node.removeChild	/ru/docs/Web/API/Node/removeChild
/ru/docs/Web/API/Node.textContent	/ru/docs/Web/API/Node/textContent
/ru/docs/Web/API/PositionError	/ru/docs/Web/API/GeolocationPositionError
/ru/docs/Web/API/WebGL_API/Adding_2D_content_to_a_WebGL_context	/ru/docs/Web/API/WebGL_API/Tutorial/Adding_2D_content_to_a_WebGL_context
/ru/docs/Web/API/WebGL_API/Animating_objects_with_WebGL	/ru/docs/Web/API/WebGL_API/Tutorial/Animating_objects_with_WebGL
/ru/docs/Web/API/WebGL_API/Getting_started_with_WebGL	/ru/docs/Web/API/WebGL_API/Tutorial/Getting_started_with_WebGL
/ru/docs/Web/API/WebGL_API/Using_shaders_to_apply_color_in_WebGL	/ru/docs/Web/API/WebGL_API/Tutorial/Using_shaders_to_apply_color_in_WebGL
/ru/docs/Web/API/WindowTimers.setTimeout	/ru/docs/Web/API/WindowTimers/setTimeout
/ru/docs/Web/API/console.timeEnd	/ru/docs/Web/API/Console/timeEnd
/ru/docs/Web/API/document.activeElement	/ru/docs/Web/API/Document/activeElement
/ru/docs/Web/API/document.createComment	/ru/docs/Web/API/Document/createComment
/ru/docs/Web/API/document.designMode	/ru/docs/Web/API/Document/designMode
/ru/docs/Web/API/document.execCommand	/ru/docs/Web/API/Document/execCommand
/ru/docs/Web/API/document.querySelector	/ru/docs/Web/API/Document/querySelector
/ru/docs/Web/API/navigator.id	/ru/docs/Web/API/Navigator/id
/ru/docs/Web/API/navigator.id.request	/ru/docs/Web/API/IdentityManager/request
/ru/docs/Web/API/range.getBoundingClientRect	/ru/docs/Web/API/Range/getBoundingClientRect
/ru/docs/Web/Apps/Fundamentals/Audio_and_video_delivery	/ru/docs/Web/Guide/Audio_and_video_delivery
/ru/docs/Web/Apps/Fundamentals/Audio_and_video_delivery/Adding_captions_and_subtitles_to_HTML5_video	/ru/docs/Web/Guide/Audio_and_video_delivery/Adding_captions_and_subtitles_to_HTML5_video
/ru/docs/Web/Apps/Fundamentals/Audio_and_video_delivery/buffering_seeking_time_ranges	/ru/docs/Web/Guide/Audio_and_video_delivery/buffering_seeking_time_ranges
/ru/docs/Web/CSS/:blank	/ru/docs/Web/CSS/:-moz-only-whitespace
/ru/docs/Web/CSS/Adjacent_sibling_selectors	/ru/docs/Web/CSS/Adjacent_sibling_combinator
/ru/docs/Web/CSS/CSS_User_Interface/Использование_URL_значений_для_свойства_cursor	/ru/docs/Web/CSS/CSS_Basic_User_Interface/Использование_URL_значений_для_свойства_cursor
/ru/docs/Web/CSS/CSS_animated_properties	/ru/docs/Web/CSS
/ru/docs/Web/CSS/Child_selectors	/ru/docs/Web/CSS/Child_combinator
/ru/docs/Web/CSS/Descendant_selectors	/ru/docs/Web/CSS/Descendant_combinator
/ru/docs/Web/CSS/General_sibling_selectors	/ru/docs/Web/CSS/General_sibling_combinator
/ru/docs/Web/CSS/Reference/background-blend-mode	/ru/docs/Web/CSS/background-blend-mode
/ru/docs/Web/CSS/Using_CSS_variables	/ru/docs/Web/CSS/Using_CSS_custom_properties
/ru/docs/Web/CSS/attr	/ru/docs/Web/CSS/attr()
/ru/docs/Web/CSS/calc	/ru/docs/Web/CSS/calc()
/ru/docs/Web/CSS/clamp	/ru/docs/Web/CSS/clamp()
/ru/docs/Web/CSS/filter-function/blur	/ru/docs/Web/CSS/filter-function/blur()
/ru/docs/Web/CSS/image-set	/ru/docs/Web/CSS/image-set()
/ru/docs/Web/CSS/linear-gradient	/ru/docs/Web/CSS/linear-gradient()
/ru/docs/Web/CSS/minmax	/ru/docs/Web/CSS/minmax()
/ru/docs/Web/CSS/radial-gradient	/ru/docs/Web/CSS/radial-gradient()
/ru/docs/Web/CSS/repeating-linear-gradient	/ru/docs/Web/CSS/repeating-linear-gradient()
/ru/docs/Web/CSS/transform-function/rotate	/ru/docs/Web/CSS/transform-function/rotate()
/ru/docs/Web/CSS/transform-function/rotate3d	/ru/docs/Web/CSS/transform-function/rotate3d()
/ru/docs/Web/CSS/transform-function/scale3d	/ru/docs/Web/CSS/transform-function/scale3d()
/ru/docs/Web/CSS/transform-function/skew	/ru/docs/Web/CSS/transform-function/skew()
/ru/docs/Web/Events/abort_(dom_abort_api)	/ru/docs/Web/API/AbortSignal/abort_event
/ru/docs/Web/Events/deviceorientation	/ru/docs/Web/API/Window/deviceorientation_event
/ru/docs/Web/Events/gamepadconnected	/ru/docs/Web/API/Window/gamepadconnected_event
/ru/docs/Web/Events/gamepaddisconnected	/ru/docs/Web/API/Window/gamepaddisconnected_event
/ru/docs/Web/Events/hashchange	/ru/docs/Web/API/Window/hashchange_event
/ru/docs/Web/Events/invalid	/ru/docs/Web/API/HTMLInputElement/invalid_event
/ru/docs/Web/Events/keypress	/ru/docs/Web/API/Document/keypress_event
/ru/docs/Web/Events/mousedown	/ru/docs/Web/API/Element/mousedown_event
/ru/docs/Web/Events/mouseleave	/ru/docs/Web/API/Element/mouseleave_event
/ru/docs/Web/Events/popstate	/ru/docs/Web/API/Window/popstate_event
/ru/docs/Web/Events/resize	/ru/docs/Web/API/Window/resize_event
/ru/docs/Web/Events/scroll	/ru/docs/Web/API/Document/scroll_event
/ru/docs/Web/Events/storage	/ru/docs/Web/API/Window/storage_event
/ru/docs/Web/Events/стримится	/ru/docs/Web/HTML/Element/video/seeking_event
/ru/docs/Web/Guide/CSS/ispolzovanie_css_animatciy	/ru/docs/Web/CSS/CSS_Animations/Ispolzovanie_CSS_animatciy
/ru/docs/Web/Guide/HTML	/ru/docs/Learn/HTML
/ru/docs/Web/Guide/HTML/Canvas_tutorial	/ru/docs/Web/API/Canvas_API/Tutorial
/ru/docs/Web/Guide/HTML/Canvas_tutorial/Basic_usage	/ru/docs/Web/API/Canvas_API/Tutorial/Basic_usage
/ru/docs/Web/Guide/HTML/Canvas_tutorial/Основы_анимации	/ru/docs/Web/API/Canvas_API/Tutorial/Основы_анимации
/ru/docs/Web/Guide/HTML/Canvas_tutorial/Применение_стилей_и_цветов	/ru/docs/Web/API/Canvas_API/Tutorial/Применение_стилей_и_цветов
/ru/docs/Web/Guide/HTML/Canvas_tutorial/Рисование_фигур	/ru/docs/Web/API/Canvas_API/Tutorial/Рисование_фигур
/ru/docs/Web/Guide/HTML/Forms	/ru/docs/Learn/HTML/Forms
/ru/docs/Web/Guide/HTML/Introduction	/ru/docs/Learn/HTML/Введение_в_HTML
/ru/docs/Web/HTML/Canvas	/ru/docs/Web/API/Canvas_API
/ru/docs/Web/HTML/Canvas/Рисование_графики_с_помощью_Canvas	/ru/docs/Web/API/Canvas_API/Tutorial
/ru/docs/Web/HTML/Element/стиль	/ru/docs/Web/HTML/Element/style
/ru/docs/Web/HTML/Использование_HTML5_audio_и_video	/ru/docs/Learn/HTML/Multimedia_and_embedding/Video_and_audio_content
/ru/docs/Web/HTML/Общие_атрибуты	/ru/docs/Web/HTML/Global_attributes
/ru/docs/Web/HTML/Общие_атрибуты/accesskey	/ru/docs/Web/HTML/Global_attributes/accesskey
/ru/docs/Web/HTML/Общие_атрибуты/class	/ru/docs/Web/HTML/Global_attributes/class
/ru/docs/Web/HTML/Общие_атрибуты/contenteditable	/ru/docs/Web/HTML/Global_attributes/contenteditable
/ru/docs/Web/HTML/Общие_атрибуты/data-*	/ru/docs/Web/HTML/Global_attributes/data-*
/ru/docs/Web/HTML/Общие_атрибуты/dropzone	/ru/docs/Web/HTML/Global_attributes/dropzone
/ru/docs/Web/HTML/Общие_атрибуты/id	/ru/docs/Web/HTML/Global_attributes/id
/ru/docs/Web/HTML/Общие_атрибуты/inputmode	/ru/docs/Web/HTML/Global_attributes/inputmode
/ru/docs/Web/HTML/Общие_атрибуты/is	/ru/docs/Web/HTML/Global_attributes/is
/ru/docs/Web/HTML/Общие_атрибуты/itemid	/ru/docs/Web/HTML/Global_attributes/itemid
/ru/docs/Web/HTML/Общие_атрибуты/lang	/ru/docs/Web/HTML/Global_attributes/lang
/ru/docs/Web/HTML/Общие_атрибуты/style	/ru/docs/Web/HTML/Global_attributes/style
/ru/docs/Web/HTML/Общие_атрибуты/tabindex	/ru/docs/Web/HTML/Global_attributes/tabindex
/ru/docs/Web/HTTP/Basics_of_HTTP/MIME_types/Полный_список_типов_MIME	/ru/docs/Web/HTTP/Basics_of_HTTP/MIME_types/Common_types
/ru/docs/Web/HTTP/Response_codes	/ru/docs/Web/HTTP/Status
/ru/docs/Web/JavaScript/ECMAScript_5_support_in_Mozilla	/ru/docs/Web/JavaScript/New_in_JavaScript/ECMAScript_5_support_in_Mozilla
/ru/docs/Web/JavaScript/Guide/Closures	/ru/docs/Web/JavaScript/Closures
/ru/docs/Web/JavaScript/Guide/EventLoop	/ru/docs/Web/JavaScript/EventLoop
/ru/docs/Web/JavaScript/Guide/Inheritance_and_the_prototype_chain	/ru/docs/Web/JavaScript/Inheritance_and_the_prototype_chain
/ru/docs/Web/JavaScript/Guide/Statements	/ru/docs/Web/JavaScript/Guide/Control_flow_and_error_handling
/ru/docs/Web/JavaScript/Guide/The_Iterator_protocol	/ru/docs/Web/JavaScript/Reference/Iteration_protocols
/ru/docs/Web/JavaScript/Guide/Values,_variables,_and_literals	/ru/docs/Web/JavaScript/Guide/Grammar_and_types
/ru/docs/Web/JavaScript/Guide_ru	/ru/docs/Web/JavaScript/Guide
/ru/docs/Web/JavaScript/Guide_ru/About	/ru/docs/Web/JavaScript/Guide/About
/ru/docs/Web/JavaScript/Guide_ru/Expressions_and_Operators	/ru/docs/Web/JavaScript/Guide/Expressions_and_Operators
/ru/docs/Web/JavaScript/Guide_ru/Functions	/ru/docs/Web/JavaScript/Guide/Functions
/ru/docs/Web/JavaScript/Guide_ru/Inheritance_and_the_prototype_chain_ru	/ru/docs/Web/JavaScript/Inheritance_and_the_prototype_chain
/ru/docs/Web/JavaScript/Guide_ru/LiveConnect_Overview	/ru/docs/Web/JavaScript/Guide/LiveConnect_Overview
/ru/docs/Web/JavaScript/Guide_ru/Regular_Expressions	/ru/docs/Web/JavaScript/Guide/Regular_Expressions
/ru/docs/Web/JavaScript/Guide_ru/Statements	/ru/docs/Web/JavaScript/Guide/Control_flow_and_error_handling
/ru/docs/Web/JavaScript/Guide_ru/Values,_variables,_and_literals	/ru/docs/Web/JavaScript/Guide/Grammar_and_types
/ru/docs/Web/JavaScript/Guide_ru/Working_with_Objects	/ru/docs/Web/JavaScript/Guide/Working_with_Objects
/ru/docs/Web/JavaScript/Guide_ru/Замыкания	/ru/docs/Web/JavaScript/Closures
/ru/docs/Web/JavaScript/New_in_JavaScript/Новое_в_JavaScript_1.6	/ru/docs/Web/JavaScript/New_in_JavaScript/1.6
/ru/docs/Web/JavaScript/Reference/Global_Objects/Array/contains	/ru/docs/Web/JavaScript/Reference/Global_Objects/Array/includes
/ru/docs/Web/JavaScript/Reference/Global_Objects/Collator	/ru/docs/Web/JavaScript/Reference/Global_Objects/Intl/Collator
/ru/docs/Web/JavaScript/Reference/Global_Objects/Collator/compare	/ru/docs/Web/JavaScript/Reference/Global_Objects/Intl/Collator/compare
/ru/docs/Web/JavaScript/Reference/Global_Objects/Collator/prototype	/ru/docs/Web/JavaScript/Reference/Global_Objects/Intl/Collator/prototype
/ru/docs/Web/JavaScript/Reference/Global_Objects/Collator/resolvedOptions	/ru/docs/Web/JavaScript/Reference/Global_Objects/Intl/Collator/resolvedOptions
/ru/docs/Web/JavaScript/Reference/Global_Objects/Collator/supportedLocalesOf	/ru/docs/Web/JavaScript/Reference/Global_Objects/Intl/Collator/supportedLocalesOf
/ru/docs/Web/JavaScript/Reference/Global_Objects/DateTimeFormat	/ru/docs/Web/JavaScript/Reference/Global_Objects/Intl/DateTimeFormat
/ru/docs/Web/JavaScript/Reference/Global_Objects/DateTimeFormat/format	/ru/docs/Web/JavaScript/Reference/Global_Objects/Intl/DateTimeFormat/format
/ru/docs/Web/JavaScript/Reference/Global_Objects/DateTimeFormat/formatToParts	/ru/docs/Web/JavaScript/Reference/Global_Objects/Intl/DateTimeFormat/formatToParts
/ru/docs/Web/JavaScript/Reference/Global_Objects/DateTimeFormat/prototype	/ru/docs/Web/JavaScript/Reference/Global_Objects/Intl/DateTimeFormat/prototype
/ru/docs/Web/JavaScript/Reference/Global_Objects/DateTimeFormat/resolvedOptions	/ru/docs/Web/JavaScript/Reference/Global_Objects/Intl/DateTimeFormat/resolvedOptions
/ru/docs/Web/JavaScript/Reference/Global_Objects/DateTimeFormat/supportedLocalesOf	/ru/docs/Web/JavaScript/Reference/Global_Objects/Intl/DateTimeFormat/supportedLocalesOf
/ru/docs/Web/JavaScript/Reference/Global_Objects/ListFormat	/ru/docs/Web/JavaScript/Reference/Global_Objects/Intl/ListFormat
/ru/docs/Web/JavaScript/Reference/Global_Objects/NumberFormat	/ru/docs/Web/JavaScript/Reference/Global_Objects/Intl/NumberFormat
/ru/docs/Web/JavaScript/Reference/Global_Objects/NumberFormat/format	/ru/docs/Web/JavaScript/Reference/Global_Objects/Intl/NumberFormat/format
/ru/docs/Web/JavaScript/Reference/Global_Objects/NumberFormat/prototype	/ru/docs/Web/JavaScript/Reference/Global_Objects/Intl/NumberFormat/prototype
/ru/docs/Web/JavaScript/Reference/Global_Objects/NumberFormat/resolvedOptions	/ru/docs/Web/JavaScript/Reference/Global_Objects/Intl/NumberFormat/resolvedOptions
/ru/docs/Web/JavaScript/Reference/Global_Objects/NumberFormat/supportedLocalesOf	/ru/docs/Web/JavaScript/Reference/Global_Objects/Intl/NumberFormat/supportedLocalesOf
/ru/docs/Web/JavaScript/Reference/Global_Objects/String/contains	/ru/docs/Web/JavaScript/Reference/Global_Objects/String/includes
/ru/docs/Web/JavaScript/Reference/Methods_Index	/ru/docs/Web/JavaScript/Reference
/ru/docs/Web/JavaScript/Reference/Operators/Spread_operator	/ru/docs/Web/JavaScript/Reference/Operators/Spread_syntax
/ru/docs/Web/JavaScript/Reference/Properties_Index	/ru/docs/Web/JavaScript/Reference
/ru/docs/Web/JavaScript/ru_JavaScript_Overview	/ru/docs/Web/JavaScript/Guide/JavaScript_Overview
/ru/docs/Web/JavaScript/Справочник_по_JavaScript_1.5	/ru/docs/Web/JavaScript/Reference
/ru/docs/Web/JavaScript/Справочник_по_JavaScript_1.5/Methods_Index	/ru/docs/Web/JavaScript/Reference
/ru/docs/Web/JavaScript/Справочник_по_JavaScript_1.5/Operators	/ru/docs/Web/JavaScript/Reference/Operators
/ru/docs/Web/JavaScript/Справочник_по_JavaScript_1.5/Operators/Operator_Precedence	/ru/docs/Web/JavaScript/Reference/Operators/Operator_Precedence
/ru/docs/Web/JavaScript/Справочник_по_JavaScript_1.5/Operators/delete	/ru/docs/Web/JavaScript/Reference/Operators/delete
/ru/docs/Web/JavaScript/Справочник_по_JavaScript_1.5/Operators/function	/ru/docs/Web/JavaScript/Reference/Operators/function
/ru/docs/Web/JavaScript/Справочник_по_JavaScript_1.5/Operators/typeof	/ru/docs/Web/JavaScript/Reference/Operators/typeof
/ru/docs/Web/JavaScript/Справочник_по_JavaScript_1.5/Operators/Оператор_Запятая	/ru/docs/Web/JavaScript/Reference/Operators/Оператор_Запятая
/ru/docs/Web/JavaScript/Справочник_по_JavaScript_1.5/Properties_Index	/ru/docs/Web/JavaScript/Reference
/ru/docs/Web/JavaScript/Справочник_по_JavaScript_1.5/Statements	/ru/docs/Web/JavaScript/Reference/Statements
/ru/docs/Web/JavaScript/Справочник_по_JavaScript_1.5/Statements/let	/ru/docs/Web/JavaScript/Reference/Statements/let
/ru/docs/Web/JavaScript/Справочник_по_JavaScript_1.5/Глобальные_объекты	/ru/docs/Web/JavaScript/Reference/Global_Objects
/ru/docs/Web/JavaScript/Справочник_по_JavaScript_1.5/Глобальные_объекты/Array	/ru/docs/Web/JavaScript/Reference/Global_Objects/Array
/ru/docs/Web/JavaScript/Справочник_по_JavaScript_1.5/Глобальные_объекты/Array/Array	/ru/docs/Web/JavaScript/Reference/Global_Objects/Array
/ru/docs/Web/JavaScript/Справочник_по_JavaScript_1.5/Глобальные_объекты/Array/MDC	/ru/docs/Web/JavaScript/Reference/Global_Objects/Array
/ru/docs/Web/JavaScript/Справочник_по_JavaScript_1.5/Глобальные_объекты/Array/map	/ru/docs/Web/JavaScript/Reference/Global_Objects/Array/map
/ru/docs/Web/JavaScript/Справочник_по_JavaScript_1.5/Глобальные_объекты/Boolean	/ru/docs/Web/JavaScript/Reference/Global_Objects/Boolean
/ru/docs/Web/JavaScript/Справочник_по_JavaScript_1.5/Глобальные_объекты/Function	/ru/docs/Web/JavaScript/Reference/Global_Objects/Function
/ru/docs/Web/JavaScript/Справочник_по_JavaScript_1.5/Глобальные_объекты/Function/bind	/ru/docs/Web/JavaScript/Reference/Global_Objects/Function/bind
/ru/docs/Web/JavaScript/Справочник_по_JavaScript_1.5/Глобальные_объекты/Function/call	/ru/docs/Web/JavaScript/Reference/Global_Objects/Function/call
/ru/docs/Web/JavaScript/Справочник_по_JavaScript_1.5/Глобальные_объекты/Function/length	/ru/docs/Web/JavaScript/Reference/Global_Objects/Function/length
/ru/docs/Web/JavaScript/Справочник_по_JavaScript_1.5/Глобальные_объекты/Function/name	/ru/docs/Web/JavaScript/Reference/Global_Objects/Function/name
/ru/docs/Web/JavaScript/Справочник_по_JavaScript_1.5/Глобальные_объекты/Function/prototype	/ru/docs/Web/JavaScript/Reference/Global_Objects/Function/prototype
/ru/docs/Web/JavaScript/Справочник_по_JavaScript_1.5/Глобальные_объекты/Math	/ru/docs/Web/JavaScript/Reference/Global_Objects/Math
/ru/docs/Web/JavaScript/Справочник_по_JavaScript_1.5/Глобальные_объекты/Object	/ru/docs/Web/JavaScript/Reference/Global_Objects/Object
/ru/docs/Web/JavaScript/Справочник_по_JavaScript_1.5/Глобальные_объекты/RegExp	/ru/docs/Web/JavaScript/Reference/Global_Objects/RegExp
/ru/docs/Web/JavaScript/Справочник_по_JavaScript_1.5/Глобальные_функции	/ru/docs/Web/JavaScript/Reference/Global_Objects
/ru/docs/Web/JavaScript/Справочник_по_JavaScript_1.5/Глобальные_функции/String	/ru/docs/Web/JavaScript/Reference/Global_Objects/String
/ru/docs/Web/JavaScript/Справочник_по_JavaScript_1.5/Глобальные_функции/isNaN	/ru/docs/Web/JavaScript/Reference/Global_Objects/isNaN
/ru/docs/Web/JavaScript/Справочник_по_JavaScript_1.5/Операторы	/ru/docs/Web/JavaScript/Reference/Operators
/ru/docs/Web/JavaScript/Справочник_по_JavaScript_1.5/Операции	/ru/docs/Web/JavaScript/Reference/Operators
/ru/docs/Web/JavaScript/Справочник_по_JavaScript_1.5/Операции/Assignment_Operators	/ru/docs/Web/JavaScript/Reference/Operators
/ru/docs/Web/JavaScript/Справочник_по_JavaScript_1.5/Операции/Арифметические_Операции	/ru/docs/Web/JavaScript/Reference/Operators/Arithmetic_Operators
/ru/docs/Web/JavaScript/Справочник_по_JavaScript_1.5/Операции/Битовые_Операции	/ru/docs/Web/JavaScript/Reference/Operators/Bitwise_Operators
/ru/docs/Web/JavaScript/Справочник_по_JavaScript_1.5/Операции/Операции_Присваивания	/ru/docs/Web/JavaScript/Reference/Operators/Assignment_Operators
/ru/docs/Web/WebGL	/ru/docs/Web/API/WebGL_API
/ru/docs/Web/WebGL/Adding_2D_content_to_a_WebGL_context	/ru/docs/Web/API/WebGL_API/Tutorial/Adding_2D_content_to_a_WebGL_context
/ru/docs/Web/WebGL/Animating_objects_with_WebGL	/ru/docs/Web/API/WebGL_API/Tutorial/Animating_objects_with_WebGL
/ru/docs/Web/WebGL/Getting_started_with_WebGL	/ru/docs/Web/API/WebGL_API/Tutorial/Getting_started_with_WebGL
/ru/docs/Web/WebGL/Using_shaders_to_apply_color_in_WebGL	/ru/docs/Web/API/WebGL_API/Tutorial/Using_shaders_to_apply_color_in_WebGL
/ru/docs/Web/Манифест	/ru/docs/Web/Manifest
/ru/docs/Web/Манифест/background_color	/ru/docs/Web/Manifest/background_color
/ru/docs/Web/Манифест/categories	/ru/docs/Web/Manifest/categories
/ru/docs/Web/Манифест/description	/ru/docs/Web/Manifest/description
/ru/docs/Web/Манифест/dir	/ru/docs/Web/Manifest/dir
/ru/docs/Web/Манифест/display	/ru/docs/Web/Manifest/display
/ru/docs/Web/Манифест/iarc_rating_id	/ru/docs/Web/Manifest/iarc_rating_id
/ru/docs/Web/Манифест/icons	/ru/docs/Web/Manifest/icons
/ru/docs/Web/Манифест/lang	/ru/docs/Web/Manifest/lang
/ru/docs/Web/Манифест/name	/ru/docs/Web/Manifest/name
/ru/docs/Web/Манифест/orientation	/ru/docs/Web/Manifest/orientation
/ru/docs/Web/Манифест/prefer_related_applications	/ru/docs/Web/Manifest/prefer_related_applications
/ru/docs/Web/Манифест/related_applications	/ru/docs/Web/Manifest/related_applications
/ru/docs/Web/Манифест/scope	/ru/docs/Web/Manifest/scope
/ru/docs/Web/Манифест/screenshots	/ru/docs/Web/Manifest/screenshots
/ru/docs/Web/Манифест/serviceworker	/ru/docs/Web/Manifest/serviceworker
/ru/docs/Web/Манифест/short_name	/ru/docs/Web/Manifest/short_name
/ru/docs/Web/Манифест/start_url	/ru/docs/Web/Manifest/start_url
/ru/docs/Web/Манифест/theme_color	/ru/docs/Web/Manifest/theme_color
/ru/docs/WebGL	/ru/docs/Web/API/WebGL_API
/ru/docs/WebGL/Using_shaders_to_apply_color_in_WebGL	/ru/docs/Web/API/WebGL_API/Tutorial/Using_shaders_to_apply_color_in_WebGL
/ru/docs/XHTML	/ru/docs/Словарь/XHTML
/ru/docs/XPath	/ru/docs/Web/XPath
/ru/docs/XPath/Funkcje	/ru/docs/Web/XPath/Funkcje
/ru/docs/XPath/Funkcje/floor	/ru/docs/Web/XPath/Funkcje/floor
/ru/docs/XSLT	/ru/docs/Web/XSLT
/ru/docs/en	/en-US/
/ru/docs/kak_soobschit_o_zavisshem_Firefox	/ru/docs/Как_сообщить_о_зависшем_Firefox
/ru/docs/nsIOutputStream:writeFrom	/ru/docs/nsIOutputStream/writeFrom
/ru/docs/Введение_(альтернативные_проекты)	/ru/docs/Introduction_(alternate)
/ru/docs/Заглавная_страница	/ru/docs/Web
/ru/docs/Новое_в_JavaScript_1.6	/ru/docs/Web/JavaScript/New_in_JavaScript/1.6
/ru/docs/Повторное_введение_в_JavaScript	/ru/docs/Web/JavaScript/A_re-introduction_to_JavaScript
/ru/docs/Руководство_по_JavaScript_1.5	/ru/docs/Web/JavaScript/Guide
/ru/docs/Руководство_по_JavaScript_1.5/Операторы	/ru/docs/Web/JavaScript/Reference/Operators
/ru/docs/Руководство_по_JavaScript_1.5/Операторы/Специальные_операторы	/ru/docs/Web/JavaScript/Reference/Operators
/ru/docs/Руководство_по_JavaScript_1.5/Операторы/Специальные_операторы/Оператор_get	/ru/docs/Web/JavaScript/Reference/Operators
/ru/docs/Руководство_по_JavaScript_1.5/Функции	/ru/docs/Web/JavaScript/Guide/Functions
/ru/docs/Руководство_по_JavaScript_1.5:Функции	/ru/docs/Web/JavaScript/Guide/Functions
/ru/docs/Руководство_разработчика_дополнений_Firefox	/ru/docs/Firefox_addons_developer_guide
/ru/docs/Словарь/AOM	/ru/docs/Glossary/Accessibility_tree
/ru/docs/Словарь/пустой_элемент	/ru/docs/Словарь/Empty_element
/ru/docs/Справочная_информация_по_Gecko_DOM:Предисловие	/ru/docs/Справочная_информация_по_Gecko_DOM/Предисловие
/ru/docs/Справочник_по_JavaScript_1.5	/ru/docs/Web/JavaScript/Reference
/ru/docs/Справочник_по_JavaScript_1.5/Глобальные_объекты	/ru/docs/Web/JavaScript/Reference/Global_Objects
/ru/docs/Справочник_по_JavaScript_1.5/Глобальные_объекты/Array	/ru/docs/Web/JavaScript/Reference/Global_Objects/Array
/ru/docs/Справочник_по_JavaScript_1.5/Глобальные_объекты/Array/Array	/ru/docs/Web/JavaScript/Reference/Global_Objects/Array
/ru/docs/Справочник_по_JavaScript_1.5/Глобальные_объекты/Array/MDC	/ru/docs/Web/JavaScript/Reference/Global_Objects/Array
/ru/docs/Справочник_по_JavaScript_1.5/Глобальные_объекты/Array/map	/ru/docs/Web/JavaScript/Reference/Global_Objects/Array/map
/ru/docs/Справочник_по_JavaScript_1.5/Глобальные_объекты/Boolean	/ru/docs/Web/JavaScript/Reference/Global_Objects/Boolean
/ru/docs/Справочник_по_JavaScript_1.5/Глобальные_объекты/Function	/ru/docs/Web/JavaScript/Reference/Global_Objects/Function
/ru/docs/Справочник_по_JavaScript_1.5/Глобальные_объекты/Function/length	/ru/docs/Web/JavaScript/Reference/Global_Objects/Function/length
/ru/docs/Справочник_по_JavaScript_1.5/Глобальные_объекты/Function/prototype	/ru/docs/Web/JavaScript/Reference/Global_Objects/Function/prototype
/ru/docs/Справочник_по_JavaScript_1.5/Глобальные_объекты/Math	/ru/docs/Web/JavaScript/Reference/Global_Objects/Math
/ru/docs/Справочник_по_JavaScript_1.5/Глобальные_объекты/Object	/ru/docs/Web/JavaScript/Reference/Global_Objects/Object
/ru/docs/Справочник_по_JavaScript_1.5/Глобальные_объекты/RegExp	/ru/docs/Web/JavaScript/Reference/Global_Objects/RegExp
/ru/docs/Справочник_по_JavaScript_1.5/Глобальные_функции	/ru/docs/Web/JavaScript/Reference/Global_Objects
/ru/docs/Справочник_по_JavaScript_1.5/Глобальные_функции/String	/ru/docs/Web/JavaScript/Reference/Global_Objects/String
/ru/docs/Справочник_по_JavaScript_1.5/Глобальные_функции/isNaN	/ru/docs/Web/JavaScript/Reference/Global_Objects/isNaN
/ru/docs/Справочник_по_JavaScript_1.5/Операторы	/ru/docs/Web/JavaScript/Reference/Operators
/ru/docs/Справочник_по_JavaScript_1.5/Операции	/ru/docs/Web/JavaScript/Reference/Operators
/ru/docs/Справочник_по_JavaScript_1.5/Операции/Assignment_Operators	/ru/docs/Web/JavaScript/Reference/Operators
/ru/docs/Справочник_по_JavaScript_1.5/Операции/Арифметические_Операции	/ru/docs/Web/JavaScript/Reference/Operators/Arithmetic_Operators
/ru/docs/Справочник_по_JavaScript_1.5/Операции/Битовые_Операции	/ru/docs/Web/JavaScript/Reference/Operators/Bitwise_Operators
/ru/docs/Справочник_по_JavaScript_1.5/Операции/Операции_Присваивания	/ru/docs/Web/JavaScript/Reference/Operators/Assignment_Operators
/ru/docs/Справочник_по_JavaScript_1.5:Глобальные_объекты	/ru/docs/Web/JavaScript/Reference/Global_Objects
/ru/docs/Справочник_по_JavaScript_1.5:Глобальные_функции:String	/ru/docs/Web/JavaScript/Reference/Global_Objects/String
/ru/docs/Справочник_по_JavaScript_1.5:Глобальные_функции:isNaN	/ru/docs/Web/JavaScript/Reference/Global_Objects/isNaN
/ru/docs/Ядро_JavaScript_1.5_Спровчник	/ru/docs/Web/JavaScript/Reference
/ru/docs/Ядро_JavaScript_1.5_Спровчник/Functions	/ru/docs/Web/JavaScript/Reference/Functions
/ru/docs/Ядро_JavaScript_1.5_Спровчник/Functions/Arrow_functions	/ru/docs/Web/JavaScript/Reference/Functions/Arrow_functions
/ru/docs/Ядро_JavaScript_1.5_Спровчник/Functions/rest_parameters	/ru/docs/Web/JavaScript/Reference/Functions/Rest_parameters
/ru/docs/Ядро_JavaScript_1.5_Спровчник:Functions	/ru/docs/Web/JavaScript/Reference/Functions
