# DO NOT EDIT THIS FILE MANUALLY.
# Use the CLI instead:
#
#    yarn content add-redirect <fromURL> <toURL>
#
# FROM-URL	TO-URL
/zh-TW/docs/AJAX	/zh-TW/docs/Learn/JavaScript/Client-side_web_APIs/Fetching_data
/zh-TW/docs/AJAX/Getting_Started	/zh-TW/docs/Learn/JavaScript/Client-side_web_APIs/Fetching_data
/zh-TW/docs/AJAX/上手篇	/zh-TW/docs/Learn/JavaScript/Client-side_web_APIs/Fetching_data
/zh-TW/docs/AJAX:上手篇	/zh-TW/docs/Learn/JavaScript/Client-side_web_APIs/Fetching_data
/zh-TW/docs/CSS	/zh-TW/docs/Web/CSS
/zh-TW/docs/CSS/-moz-border-image	/zh-TW/docs/Web/CSS/border-image
/zh-TW/docs/CSS/@font-face	/zh-TW/docs/Web/CSS/@font-face
/zh-TW/docs/CSS/border-image	/zh-TW/docs/Web/CSS/border-image
/zh-TW/docs/CSS/border-image/border-image	/zh-TW/docs/Web/CSS/border-image
/zh-TW/docs/CSS_一般問題	/zh-TW/docs/Learn/CSS/Howto/CSS_FAQ
/zh-TW/docs/Canvas_tutorial	/en-US/docs/Web/API/Canvas_API/Tutorial
/zh-TW/docs/Core_JavaScript_1.5_教學	/zh-TW/docs/Web/JavaScript/Guide
/zh-TW/docs/Core_JavaScript_1.5_教學/JavaScript_概要	/zh-TW/docs/Web/JavaScript/Guide/Introduction
/zh-TW/docs/Core_JavaScript_1.5_教學/Unicode	/zh-TW/docs/Web/JavaScript/Guide/Grammar_and_types
/zh-TW/docs/Core_JavaScript_1.5_教學/以類別為基礎的語言_vs._以原型為基礎的語言	/zh-TW/docs/Web/JavaScript/Inheritance_and_the_prototype_chain
/zh-TW/docs/Core_JavaScript_1.5_教學/值	/zh-TW/docs/Web/JavaScript/Guide/Grammar_and_types
/zh-TW/docs/Core_JavaScript_1.5_教學/再談屬性的繼承	/zh-TW/docs/Web/JavaScript/Inheritance_and_the_prototype_chain
/zh-TW/docs/Core_JavaScript_1.5_教學/再談屬性的繼承/實體關係的確定	/zh-TW/docs/Web/JavaScript/Inheritance_and_the_prototype_chain
/zh-TW/docs/Core_JavaScript_1.5_教學/再談屬性的繼承/局域值和繼承值	/zh-TW/docs/Web/JavaScript/Inheritance_and_the_prototype_chain
/zh-TW/docs/Core_JavaScript_1.5_教學/再談屬性的繼承/建構子中的全域資訊	/zh-TW/docs/Web/JavaScript/Inheritance_and_the_prototype_chain
/zh-TW/docs/Core_JavaScript_1.5_教學/再談屬性的繼承/沒有多重繼承	/zh-TW/docs/Web/JavaScript/Inheritance_and_the_prototype_chain
/zh-TW/docs/Core_JavaScript_1.5_教學/函數的呼叫	/zh-TW/docs/Web/JavaScript/Guide/Functions
/zh-TW/docs/Core_JavaScript_1.5_教學/函數的定義	/zh-TW/docs/Web/JavaScript/Guide/Functions
/zh-TW/docs/Core_JavaScript_1.5_教學/區塊文法	/zh-TW/docs/Web/JavaScript/Guide/Control_flow_and_error_handling
/zh-TW/docs/Core_JavaScript_1.5_教學/區塊語法	/zh-TW/docs/Web/JavaScript/Guide/Control_flow_and_error_handling
/zh-TW/docs/Core_JavaScript_1.5_教學/字面表達	/zh-TW/docs/Web/JavaScript/Guide/Grammar_and_types
/zh-TW/docs/Core_JavaScript_1.5_教學/常數	/zh-TW/docs/Web/JavaScript/Guide/Grammar_and_types
/zh-TW/docs/Core_JavaScript_1.5_教學/循環語法	/zh-TW/docs/Web/JavaScript/Guide/Control_flow_and_error_handling
/zh-TW/docs/Core_JavaScript_1.5_教學/條件文法	/zh-TW/docs/Web/JavaScript/Guide/Control_flow_and_error_handling
/zh-TW/docs/Core_JavaScript_1.5_教學/條件語法	/zh-TW/docs/Web/JavaScript/Guide/Control_flow_and_error_handling
/zh-TW/docs/Core_JavaScript_1.5_教學/正則表達式模式的編寫	/zh-TW/docs/Web/JavaScript/Guide/Regular_expressions
/zh-TW/docs/Core_JavaScript_1.5_教學/正則表達式的建立	/zh-TW/docs/Web/JavaScript/Guide/Regular_expressions
/zh-TW/docs/Core_JavaScript_1.5_教學/正則表達式的運用	/zh-TW/docs/Web/JavaScript/Guide/Regular_expressions
/zh-TW/docs/Core_JavaScript_1.5_教學/正則表達式的運用/使用標誌的進階搜尋	/zh-TW/docs/Web/JavaScript/Guide/Regular_expressions
/zh-TW/docs/Core_JavaScript_1.5_教學/正則表達式的運用/括弧子字串的比對結果的運用	/zh-TW/docs/Web/JavaScript/Guide/Regular_expressions
/zh-TW/docs/Core_JavaScript_1.5_教學/正則表達式的運用/正則表達式的範例	/zh-TW/docs/Web/JavaScript/Guide/Regular_expressions
/zh-TW/docs/Core_JavaScript_1.5_教學/正規表達式模式的編寫	/zh-TW/docs/Web/JavaScript/Guide/Regular_expressions
/zh-TW/docs/Core_JavaScript_1.5_教學/正規表達式的建立	/zh-TW/docs/Web/JavaScript/Guide/Regular_expressions
/zh-TW/docs/Core_JavaScript_1.5_教學/正規表達式的運用	/zh-TW/docs/Web/JavaScript/Guide/Regular_expressions
/zh-TW/docs/Core_JavaScript_1.5_教學/正規表達式的運用/使用標誌的進階搜尋	/zh-TW/docs/Web/JavaScript/Guide/Regular_expressions
/zh-TW/docs/Core_JavaScript_1.5_教學/正規表達式的運用/括弧子字串的比對結果的運用	/zh-TW/docs/Web/JavaScript/Guide/Regular_expressions
/zh-TW/docs/Core_JavaScript_1.5_教學/正規表達式的運用/正則表達式的範例	/zh-TW/docs/Web/JavaScript/Guide/Regular_expressions
/zh-TW/docs/Core_JavaScript_1.5_教學/正規表達式的運用/正規表達式的範例	/zh-TW/docs/Web/JavaScript/Guide/Regular_expressions
/zh-TW/docs/Core_JavaScript_1.5_教學/繼承	/zh-TW/docs/Web/JavaScript/Inheritance_and_the_prototype_chain
/zh-TW/docs/Core_JavaScript_1.5_教學/職員的例子	/zh-TW/docs/Learn/JavaScript/Objects
/zh-TW/docs/Core_JavaScript_1.5_教學/職員的例子/更靈活的建構子	/zh-TW/docs/Web/JavaScript/Inheritance_and_the_prototype_chain
/zh-TW/docs/Core_JavaScript_1.5_教學/職員的例子/物件的屬性	/zh-TW/docs/Learn/JavaScript/Objects/Object_prototypes
/zh-TW/docs/Core_JavaScript_1.5_教學/職員的例子/物件的屬性/屬性的繼承	/zh-TW/docs/Web/JavaScript/Inheritance_and_the_prototype_chain
/zh-TW/docs/Core_JavaScript_1.5_教學/表達式	/zh-TW/docs/Web/JavaScript/Guide/Expressions_and_operators
/zh-TW/docs/Core_JavaScript_1.5_教學/註解	/zh-TW/docs/Web/JavaScript/Guide/Control_flow_and_error_handling
/zh-TW/docs/Core_JavaScript_1.5_教學/變數	/zh-TW/docs/Web/JavaScript/Guide/Grammar_and_types
/zh-TW/docs/Core_JavaScript_1.5_教學/運算子	/zh-TW/docs/Web/JavaScript/Guide/Expressions_and_operators
/zh-TW/docs/Core_JavaScript_1.5_教學/運算子/代入運算子	/zh-TW/docs/Web/JavaScript/Guide/Expressions_and_operators
/zh-TW/docs/Core_JavaScript_1.5_教學/運算子/位元運算子	/zh-TW/docs/Web/JavaScript/Guide/Expressions_and_operators
/zh-TW/docs/Core_JavaScript_1.5_教學/運算子/字串運算子	/zh-TW/docs/Web/JavaScript/Guide/Expressions_and_operators
/zh-TW/docs/Core_JavaScript_1.5_教學/運算子/特殊運算子	/zh-TW/docs/Web/JavaScript/Guide/Expressions_and_operators
/zh-TW/docs/Core_JavaScript_1.5_教學/運算子/算術運算子	/zh-TW/docs/Web/JavaScript/Guide/Expressions_and_operators
/zh-TW/docs/Core_JavaScript_1.5_教學/運算子/邏輯運算子	/zh-TW/docs/Web/JavaScript/Guide/Expressions_and_operators
/zh-TW/docs/Core_JavaScript_1.5_教學/閉包的運用	/zh-TW/docs/Web/JavaScript/Closures
/zh-TW/docs/Core_JavaScript_1.5_教學/關於	/zh-TW/docs/Web/JavaScript/Guide/Introduction
/zh-TW/docs/Core_JavaScript_1.5_教學/陣列的運用	/zh-TW/docs/Web/JavaScript/Guide
/zh-TW/docs/Core_JavaScript_1.5_教學/預先定義的函數	/zh-TW/docs/Web/JavaScript/Guide/Functions
/zh-TW/docs/Core_JavaScript_1.5_教學/預先定義的函數/Number_和_String_函數	/zh-TW/docs/Web/JavaScript/Guide/Functions
/zh-TW/docs/Core_JavaScript_1.5_教學/預先定義的函數/escape_和_unescape_函數	/zh-TW/docs/Web/JavaScript/Guide/Functions
/zh-TW/docs/Core_JavaScript_1.5_教學/預先定義的函數/eval_函數	/zh-TW/docs/Web/JavaScript/Guide/Functions
/zh-TW/docs/Core_JavaScript_1.5_教學/預先定義的函數/isFinite_函數	/zh-TW/docs/Web/JavaScript/Guide/Functions
/zh-TW/docs/Core_JavaScript_1.5_教學/預先定義的函數/isNaN_函數	/zh-TW/docs/Web/JavaScript/Guide/Functions
/zh-TW/docs/Core_JavaScript_1.5_教學/預先定義的核心物件	/zh-TW/docs/Web/JavaScript/Guide
/zh-TW/docs/Core_JavaScript_1.5_正規表達式的建立/正規表達式的建立	/zh-TW/docs/Web/JavaScript/Guide/Regular_expressions
/zh-TW/docs/DOM	/en-US/docs/Web/API/Document_Object_Model
/zh-TW/docs/DOM/XMLHttpRequest	/zh-TW/docs/Web/API/XMLHttpRequest
/zh-TW/docs/DOM/XMLHttpRequest/FormData	/zh-TW/docs/Web/API/FormData
/zh-TW/docs/DOM/XMLHttpRequest/Using_XMLHttpRequest	/zh-TW/docs/Web/API/XMLHttpRequest_API/Using_XMLHttpRequest
/zh-TW/docs/DOM_中的空白字元	/zh-TW/docs/Web/API/Document_Object_Model/Whitespace
/zh-TW/docs/DragDrop	/zh-TW/docs/Web/API/HTML_Drag_and_Drop_API
/zh-TW/docs/DragDrop/Drag_and_Drop	/zh-TW/docs/Web/API/HTML_Drag_and_Drop_API
/zh-TW/docs/Drawing_text_using_a_canvas	/zh-TW/docs/Web/API/Canvas_API/Tutorial/Drawing_text
/zh-TW/docs/Firefox_2	/zh-TW/docs/Mozilla/Firefox/Releases/2
/zh-TW/docs/Firefox_2_技術文件	/zh-TW/docs/Mozilla/Firefox/Releases/2
/zh-TW/docs/Firefox_2_的安全功能	/zh-TW/docs/Mozilla/Firefox/Releases/2/Security_changes
/zh-TW/docs/Firefox_3_Dom_Improvements	/zh-TW/docs/Mozilla/Firefox/Releases/3/DOM_improvements
/zh-TW/docs/Firefox_3_Online_and_Offline_Events	/en-US/docs/Web/API/Navigator/onLine
/zh-TW/docs/Firefox_3_for_developers	/zh-TW/docs/Mozilla/Firefox/Releases/3
/zh-TW/docs/Firefox_3_技術文件	/zh-TW/docs/Mozilla/Firefox/Releases/3
/zh-TW/docs/Games/Workflows/2D_Breakout_game_pure_JavaScript	/zh-TW/docs/Games/Tutorials/2D_Breakout_game_pure_JavaScript
/zh-TW/docs/Games/Workflows/2D_Breakout_game_pure_JavaScript/Bounce_off_the_walls	/zh-TW/docs/Games/Tutorials/2D_Breakout_game_pure_JavaScript/Bounce_off_the_walls
/zh-TW/docs/Games/Workflows/2D_Breakout_game_pure_JavaScript/Create_the_Canvas_and_draw_on_it	/zh-TW/docs/Games/Tutorials/2D_Breakout_game_pure_JavaScript/Create_the_Canvas_and_draw_on_it
/zh-TW/docs/Games/Workflows/2D_Breakout_game_pure_JavaScript/Move_the_ball	/zh-TW/docs/Games/Tutorials/2D_Breakout_game_pure_JavaScript/Move_the_ball
/zh-TW/docs/Glossary/404	/zh-TW/docs/Web/HTTP/Status/404
/zh-TW/docs/Glossary/502	/zh-TW/docs/Web/HTTP/Status/502
/zh-TW/docs/Glossary/Empty_element	/zh-TW/docs/Glossary/Void_element
/zh-TW/docs/Glossary/Routers	/zh-TW/docs/Glossary/Router
/zh-TW/docs/Glossary/偽元素	/zh-TW/docs/Glossary/Pseudo-element
/zh-TW/docs/Glossary/字元	/zh-TW/docs/Glossary/Character
/zh-TW/docs/Glossary/字元編碼	/zh-TW/docs/Glossary/Character_encoding
/zh-TW/docs/Glossary/布林	/zh-TW/docs/Glossary/Boolean
/zh-TW/docs/Glossary/抽象化	/zh-TW/docs/Glossary/Abstraction
/zh-TW/docs/Glossary/瀏覽器	/zh-TW/docs/Glossary/Browser
/zh-TW/docs/Glossary/物件導向程式設計(OOP)	/zh-TW/docs/Glossary/OOP
/zh-TW/docs/Glossary/資料結構	/zh-TW/docs/Glossary/Data_structure
/zh-TW/docs/Glossary/陣列	/zh-TW/docs/Glossary/Array
/zh-TW/docs/HTML	/zh-TW/docs/Web/HTML
/zh-TW/docs/HTML/Canvas	/zh-TW/docs/Web/API/Canvas_API
/zh-TW/docs/HTML/HTML5	/zh-TW/docs/Glossary/HTML5
/zh-TW/docs/HTML/HTML5_表單	/zh-TW/docs/Learn/Forms
/zh-TW/docs/HTML/Introduction	/zh-CN/docs/learn/HTML/Introduction_to_HTML
/zh-TW/docs/HTTP	/zh-TW/docs/Web/HTTP
/zh-TW/docs/HTTP/Access_control_CORS	/zh-TW/docs/Web/HTTP/CORS
/zh-TW/docs/HTTP/Browser_detection_using_the_user_agent	/zh-TW/docs/Web/HTTP/Browser_detection_using_the_user_agent
/zh-TW/docs/HTTP/Link_prefetching_FAQ	/zh-TW/docs/Glossary/Prefetch
/zh-TW/docs/HTTP/Response_codes	/zh-TW/docs/Web/HTTP/Status
/zh-TW/docs/HTTP/X-Frame-Options	/zh-TW/docs/Web/HTTP/Headers/X-Frame-Options
/zh-TW/docs/IndexedDB	/zh-TW/docs/Web/API/IndexedDB_API
/zh-TW/docs/IndexedDB/Basic_Concepts_Behind_IndexedDB	/en-US/docs/Web/API/IndexedDB_API/Basic_Terminology
/zh-TW/docs/IndexedDB/Using_IndexedDB	/zh-TW/docs/Web/API/IndexedDB_API/Using_IndexedDB
/zh-TW/docs/JavaScript	/zh-TW/docs/Web/JavaScript
/zh-TW/docs/JavaScript/About_JavaScript	/zh-TW/docs/Web/JavaScript
/zh-TW/docs/JavaScript/Guide	/zh-TW/docs/Web/JavaScript/Guide
/zh-TW/docs/JavaScript/Guide/Details_of_the_Object_Model	/zh-TW/docs/Web/JavaScript/Inheritance_and_the_prototype_chain
/zh-TW/docs/JavaScript/Guide/Functions	/zh-TW/docs/Web/JavaScript/Guide/Functions
/zh-TW/docs/JavaScript/Guide/JavaScript_Overview	/zh-TW/docs/Web/JavaScript/Guide/Introduction
/zh-TW/docs/JavaScript/Guide/JavaScript_Overview-redirect-1	/zh-TW/docs/Web/JavaScript/Guide/Introduction
/zh-TW/docs/JavaScript/Guide/JavaScript_概觀	/zh-TW/docs/Web/JavaScript/Guide/Introduction
/zh-TW/docs/JavaScript/Guide/JavaScript_概觀（JavaScript_Overview）	/zh-TW/docs/Web/JavaScript/Guide/Introduction
/zh-TW/docs/JavaScript/Guide/Obsolete_Pages	/zh-TW/docs/Web/JavaScript/Guide
/zh-TW/docs/JavaScript/Guide/Obsolete_Pages/JavaScript_概要	/zh-TW/docs/Web/JavaScript/Guide/Introduction
/zh-TW/docs/JavaScript/Guide/Obsolete_Pages/Unicode	/zh-TW/docs/Web/JavaScript/Guide/Grammar_and_types
/zh-TW/docs/JavaScript/Guide/Obsolete_Pages/以類別為基礎的語言_vs._以原型為基礎的語言	/zh-TW/docs/Web/JavaScript/Inheritance_and_the_prototype_chain
/zh-TW/docs/JavaScript/Guide/Obsolete_Pages/值	/zh-TW/docs/Web/JavaScript/Guide/Grammar_and_types
/zh-TW/docs/JavaScript/Guide/Obsolete_Pages/再談屬性的繼承	/zh-TW/docs/Web/JavaScript/Inheritance_and_the_prototype_chain
/zh-TW/docs/JavaScript/Guide/Obsolete_Pages/再談屬性的繼承/實體關係的確定	/zh-TW/docs/Web/JavaScript/Inheritance_and_the_prototype_chain
/zh-TW/docs/JavaScript/Guide/Obsolete_Pages/再談屬性的繼承/局域值和繼承值	/zh-TW/docs/Web/JavaScript/Inheritance_and_the_prototype_chain
/zh-TW/docs/JavaScript/Guide/Obsolete_Pages/再談屬性的繼承/建構子中的全域資訊	/zh-TW/docs/Web/JavaScript/Inheritance_and_the_prototype_chain
/zh-TW/docs/JavaScript/Guide/Obsolete_Pages/再談屬性的繼承/沒有多重繼承	/zh-TW/docs/Web/JavaScript/Inheritance_and_the_prototype_chain
/zh-TW/docs/JavaScript/Guide/Obsolete_Pages/函數的呼叫	/zh-TW/docs/Web/JavaScript/Guide/Functions
/zh-TW/docs/JavaScript/Guide/Obsolete_Pages/函數的定義	/zh-TW/docs/Web/JavaScript/Guide/Functions
/zh-TW/docs/JavaScript/Guide/Obsolete_Pages/區塊文法	/zh-TW/docs/Web/JavaScript/Guide/Control_flow_and_error_handling
/zh-TW/docs/JavaScript/Guide/Obsolete_Pages/區塊語法	/zh-TW/docs/Web/JavaScript/Guide/Control_flow_and_error_handling
/zh-TW/docs/JavaScript/Guide/Obsolete_Pages/字面表達	/zh-TW/docs/Web/JavaScript/Guide/Grammar_and_types
/zh-TW/docs/JavaScript/Guide/Obsolete_Pages/常數	/zh-TW/docs/Web/JavaScript/Guide/Grammar_and_types
/zh-TW/docs/JavaScript/Guide/Obsolete_Pages/循環語法	/zh-TW/docs/Web/JavaScript/Guide/Control_flow_and_error_handling
/zh-TW/docs/JavaScript/Guide/Obsolete_Pages/條件文法	/zh-TW/docs/Web/JavaScript/Guide/Control_flow_and_error_handling
/zh-TW/docs/JavaScript/Guide/Obsolete_Pages/條件語法	/zh-TW/docs/Web/JavaScript/Guide/Control_flow_and_error_handling
/zh-TW/docs/JavaScript/Guide/Obsolete_Pages/正則表達式模式的編寫	/zh-TW/docs/Web/JavaScript/Guide/Regular_expressions
/zh-TW/docs/JavaScript/Guide/Obsolete_Pages/正則表達式的建立	/zh-TW/docs/Web/JavaScript/Guide/Regular_expressions
/zh-TW/docs/JavaScript/Guide/Obsolete_Pages/正則表達式的運用	/zh-TW/docs/Web/JavaScript/Guide/Regular_expressions
/zh-TW/docs/JavaScript/Guide/Obsolete_Pages/正則表達式的運用/使用標誌的進階搜尋	/zh-TW/docs/Web/JavaScript/Guide/Regular_expressions
/zh-TW/docs/JavaScript/Guide/Obsolete_Pages/正則表達式的運用/括弧子字串的比對結果的運用	/zh-TW/docs/Web/JavaScript/Guide/Regular_expressions
/zh-TW/docs/JavaScript/Guide/Obsolete_Pages/正則表達式的運用/正則表達式的範例	/zh-TW/docs/Web/JavaScript/Guide/Regular_expressions
/zh-TW/docs/JavaScript/Guide/Obsolete_Pages/正規表達式模式的編寫	/zh-TW/docs/Web/JavaScript/Guide/Regular_expressions
/zh-TW/docs/JavaScript/Guide/Obsolete_Pages/正規表達式的建立	/zh-TW/docs/Web/JavaScript/Guide/Regular_expressions
/zh-TW/docs/JavaScript/Guide/Obsolete_Pages/正規表達式的運用	/zh-TW/docs/Web/JavaScript/Guide/Regular_expressions
/zh-TW/docs/JavaScript/Guide/Obsolete_Pages/正規表達式的運用/使用標誌的進階搜尋	/zh-TW/docs/Web/JavaScript/Guide/Regular_expressions
/zh-TW/docs/JavaScript/Guide/Obsolete_Pages/正規表達式的運用/括弧子字串的比對結果的運用	/zh-TW/docs/Web/JavaScript/Guide/Regular_expressions
/zh-TW/docs/JavaScript/Guide/Obsolete_Pages/正規表達式的運用/正則表達式的範例	/zh-TW/docs/Web/JavaScript/Guide/Regular_expressions
/zh-TW/docs/JavaScript/Guide/Obsolete_Pages/正規表達式的運用/正規表達式的範例	/zh-TW/docs/Web/JavaScript/Guide/Regular_expressions
/zh-TW/docs/JavaScript/Guide/Obsolete_Pages/繼承	/zh-TW/docs/Web/JavaScript/Inheritance_and_the_prototype_chain
/zh-TW/docs/JavaScript/Guide/Obsolete_Pages/職員的例子	/zh-TW/docs/Learn/JavaScript/Objects
/zh-TW/docs/JavaScript/Guide/Obsolete_Pages/職員的例子/更靈活的建構子	/zh-TW/docs/Web/JavaScript/Inheritance_and_the_prototype_chain
/zh-TW/docs/JavaScript/Guide/Obsolete_Pages/職員的例子/物件的屬性	/zh-TW/docs/Learn/JavaScript/Objects/Object_prototypes
/zh-TW/docs/JavaScript/Guide/Obsolete_Pages/職員的例子/物件的屬性/屬性的繼承	/zh-TW/docs/Web/JavaScript/Inheritance_and_the_prototype_chain
/zh-TW/docs/JavaScript/Guide/Obsolete_Pages/表達式	/zh-TW/docs/Web/JavaScript/Guide/Expressions_and_operators
/zh-TW/docs/JavaScript/Guide/Obsolete_Pages/註解	/zh-TW/docs/Web/JavaScript/Guide/Control_flow_and_error_handling
/zh-TW/docs/JavaScript/Guide/Obsolete_Pages/變數	/zh-TW/docs/Web/JavaScript/Guide/Grammar_and_types
/zh-TW/docs/JavaScript/Guide/Obsolete_Pages/運算子	/zh-TW/docs/Web/JavaScript/Guide/Expressions_and_operators
/zh-TW/docs/JavaScript/Guide/Obsolete_Pages/運算子/代入運算子	/zh-TW/docs/Web/JavaScript/Guide/Expressions_and_operators
/zh-TW/docs/JavaScript/Guide/Obsolete_Pages/運算子/位元運算子	/zh-TW/docs/Web/JavaScript/Guide/Expressions_and_operators
/zh-TW/docs/JavaScript/Guide/Obsolete_Pages/運算子/字串運算子	/zh-TW/docs/Web/JavaScript/Guide/Expressions_and_operators
/zh-TW/docs/JavaScript/Guide/Obsolete_Pages/運算子/特殊運算子	/zh-TW/docs/Web/JavaScript/Guide/Expressions_and_operators
/zh-TW/docs/JavaScript/Guide/Obsolete_Pages/運算子/算術運算子	/zh-TW/docs/Web/JavaScript/Guide/Expressions_and_operators
/zh-TW/docs/JavaScript/Guide/Obsolete_Pages/運算子/邏輯運算子	/zh-TW/docs/Web/JavaScript/Guide/Expressions_and_operators
/zh-TW/docs/JavaScript/Guide/Obsolete_Pages/閉包的運用	/zh-TW/docs/Web/JavaScript/Closures
/zh-TW/docs/JavaScript/Guide/Obsolete_Pages/關於	/zh-TW/docs/Web/JavaScript/Guide/Introduction
/zh-TW/docs/JavaScript/Guide/Obsolete_Pages/陣列的運用	/zh-TW/docs/Web/JavaScript/Guide
/zh-TW/docs/JavaScript/Guide/Obsolete_Pages/預先定義的函數	/zh-TW/docs/Web/JavaScript/Guide/Functions
/zh-TW/docs/JavaScript/Guide/Obsolete_Pages/預先定義的函數/Number_和_String_函數	/zh-TW/docs/Web/JavaScript/Guide/Functions
/zh-TW/docs/JavaScript/Guide/Obsolete_Pages/預先定義的函數/escape_和_unescape_函數	/zh-TW/docs/Web/JavaScript/Guide/Functions
/zh-TW/docs/JavaScript/Guide/Obsolete_Pages/預先定義的函數/eval_函數	/zh-TW/docs/Web/JavaScript/Guide/Functions
/zh-TW/docs/JavaScript/Guide/Obsolete_Pages/預先定義的函數/isFinite_函數	/zh-TW/docs/Web/JavaScript/Guide/Functions
/zh-TW/docs/JavaScript/Guide/Obsolete_Pages/預先定義的函數/isNaN_函數	/zh-TW/docs/Web/JavaScript/Guide/Functions
/zh-TW/docs/JavaScript/Guide/Obsolete_Pages/預先定義的核心物件	/zh-TW/docs/Web/JavaScript/Guide
/zh-TW/docs/JavaScript/Guide/Regular_Expressions	/zh-TW/docs/Web/JavaScript/Guide/Regular_expressions
/zh-TW/docs/JavaScript/Guide/Values,_variables,_and_literals	/zh-TW/docs/Web/JavaScript/Guide/Grammar_and_types
/zh-TW/docs/JavaScript/Obsolete_Pages/Obsolete_Pages	/zh-TW/docs/Web/JavaScript/Guide
/zh-TW/docs/JavaScript/Obsolete_Pages/Obsolete_Pages/Obsolete_Pages	/zh-TW/docs/Web/JavaScript/Guide
/zh-TW/docs/JavaScript/Obsolete_Pages/Obsolete_Pages/Obsolete_Pages/JavaScript_概要	/zh-TW/docs/Web/JavaScript/Guide/Introduction
/zh-TW/docs/JavaScript/Obsolete_Pages/Obsolete_Pages/Obsolete_Pages/Unicode	/zh-TW/docs/Web/JavaScript/Guide/Grammar_and_types
/zh-TW/docs/JavaScript/Obsolete_Pages/Obsolete_Pages/Obsolete_Pages/以類別為基礎的語言_vs._以原型為基礎的語言	/zh-TW/docs/Web/JavaScript/Inheritance_and_the_prototype_chain
/zh-TW/docs/JavaScript/Obsolete_Pages/Obsolete_Pages/Obsolete_Pages/值	/zh-TW/docs/Web/JavaScript/Guide/Grammar_and_types
/zh-TW/docs/JavaScript/Obsolete_Pages/Obsolete_Pages/Obsolete_Pages/再談屬性的繼承	/zh-TW/docs/Web/JavaScript/Inheritance_and_the_prototype_chain
/zh-TW/docs/JavaScript/Obsolete_Pages/Obsolete_Pages/Obsolete_Pages/再談屬性的繼承/實體關係的確定	/zh-TW/docs/Web/JavaScript/Inheritance_and_the_prototype_chain
/zh-TW/docs/JavaScript/Obsolete_Pages/Obsolete_Pages/Obsolete_Pages/再談屬性的繼承/局域值和繼承值	/zh-TW/docs/Web/JavaScript/Inheritance_and_the_prototype_chain
/zh-TW/docs/JavaScript/Obsolete_Pages/Obsolete_Pages/Obsolete_Pages/再談屬性的繼承/建構子中的全域資訊	/zh-TW/docs/Web/JavaScript/Inheritance_and_the_prototype_chain
/zh-TW/docs/JavaScript/Obsolete_Pages/Obsolete_Pages/Obsolete_Pages/再談屬性的繼承/沒有多重繼承	/zh-TW/docs/Web/JavaScript/Inheritance_and_the_prototype_chain
/zh-TW/docs/JavaScript/Obsolete_Pages/Obsolete_Pages/Obsolete_Pages/函數的呼叫	/zh-TW/docs/Web/JavaScript/Guide/Functions
/zh-TW/docs/JavaScript/Obsolete_Pages/Obsolete_Pages/Obsolete_Pages/函數的定義	/zh-TW/docs/Web/JavaScript/Guide/Functions
/zh-TW/docs/JavaScript/Obsolete_Pages/Obsolete_Pages/Obsolete_Pages/區塊文法	/zh-TW/docs/Web/JavaScript/Guide/Control_flow_and_error_handling
/zh-TW/docs/JavaScript/Obsolete_Pages/Obsolete_Pages/Obsolete_Pages/區塊語法	/zh-TW/docs/Web/JavaScript/Guide/Control_flow_and_error_handling
/zh-TW/docs/JavaScript/Obsolete_Pages/Obsolete_Pages/Obsolete_Pages/字面表達	/zh-TW/docs/Web/JavaScript/Guide/Grammar_and_types
/zh-TW/docs/JavaScript/Obsolete_Pages/Obsolete_Pages/Obsolete_Pages/常數	/zh-TW/docs/Web/JavaScript/Guide/Grammar_and_types
/zh-TW/docs/JavaScript/Obsolete_Pages/Obsolete_Pages/Obsolete_Pages/循環語法	/zh-TW/docs/Web/JavaScript/Guide/Control_flow_and_error_handling
/zh-TW/docs/JavaScript/Obsolete_Pages/Obsolete_Pages/Obsolete_Pages/條件文法	/zh-TW/docs/Web/JavaScript/Guide/Control_flow_and_error_handling
/zh-TW/docs/JavaScript/Obsolete_Pages/Obsolete_Pages/Obsolete_Pages/條件語法	/zh-TW/docs/Web/JavaScript/Guide/Control_flow_and_error_handling
/zh-TW/docs/JavaScript/Obsolete_Pages/Obsolete_Pages/Obsolete_Pages/正則表達式模式的編寫	/zh-TW/docs/Web/JavaScript/Guide/Regular_expressions
/zh-TW/docs/JavaScript/Obsolete_Pages/Obsolete_Pages/Obsolete_Pages/正則表達式的建立	/zh-TW/docs/Web/JavaScript/Guide/Regular_expressions
/zh-TW/docs/JavaScript/Obsolete_Pages/Obsolete_Pages/Obsolete_Pages/正則表達式的運用	/zh-TW/docs/Web/JavaScript/Guide/Regular_expressions
/zh-TW/docs/JavaScript/Obsolete_Pages/Obsolete_Pages/Obsolete_Pages/正則表達式的運用/使用標誌的進階搜尋	/zh-TW/docs/Web/JavaScript/Guide/Regular_expressions
/zh-TW/docs/JavaScript/Obsolete_Pages/Obsolete_Pages/Obsolete_Pages/正則表達式的運用/括弧子字串的比對結果的運用	/zh-TW/docs/Web/JavaScript/Guide/Regular_expressions
/zh-TW/docs/JavaScript/Obsolete_Pages/Obsolete_Pages/Obsolete_Pages/正則表達式的運用/正則表達式的範例	/zh-TW/docs/Web/JavaScript/Guide/Regular_expressions
/zh-TW/docs/JavaScript/Obsolete_Pages/Obsolete_Pages/Obsolete_Pages/正規表達式模式的編寫	/zh-TW/docs/Web/JavaScript/Guide/Regular_expressions
/zh-TW/docs/JavaScript/Obsolete_Pages/Obsolete_Pages/Obsolete_Pages/正規表達式的建立	/zh-TW/docs/Web/JavaScript/Guide/Regular_expressions
/zh-TW/docs/JavaScript/Obsolete_Pages/Obsolete_Pages/Obsolete_Pages/正規表達式的運用	/zh-TW/docs/Web/JavaScript/Guide/Regular_expressions
/zh-TW/docs/JavaScript/Obsolete_Pages/Obsolete_Pages/Obsolete_Pages/正規表達式的運用/使用標誌的進階搜尋	/zh-TW/docs/Web/JavaScript/Guide/Regular_expressions
/zh-TW/docs/JavaScript/Obsolete_Pages/Obsolete_Pages/Obsolete_Pages/正規表達式的運用/括弧子字串的比對結果的運用	/zh-TW/docs/Web/JavaScript/Guide/Regular_expressions
/zh-TW/docs/JavaScript/Obsolete_Pages/Obsolete_Pages/Obsolete_Pages/正規表達式的運用/正則表達式的範例	/zh-TW/docs/Web/JavaScript/Guide/Regular_expressions
/zh-TW/docs/JavaScript/Obsolete_Pages/Obsolete_Pages/Obsolete_Pages/正規表達式的運用/正規表達式的範例	/zh-TW/docs/Web/JavaScript/Guide/Regular_expressions
/zh-TW/docs/JavaScript/Obsolete_Pages/Obsolete_Pages/Obsolete_Pages/繼承	/zh-TW/docs/Web/JavaScript/Inheritance_and_the_prototype_chain
/zh-TW/docs/JavaScript/Obsolete_Pages/Obsolete_Pages/Obsolete_Pages/職員的例子	/zh-TW/docs/Learn/JavaScript/Objects
/zh-TW/docs/JavaScript/Obsolete_Pages/Obsolete_Pages/Obsolete_Pages/職員的例子/更靈活的建構子	/zh-TW/docs/Web/JavaScript/Inheritance_and_the_prototype_chain
/zh-TW/docs/JavaScript/Obsolete_Pages/Obsolete_Pages/Obsolete_Pages/職員的例子/物件的屬性	/zh-TW/docs/Learn/JavaScript/Objects/Object_prototypes
/zh-TW/docs/JavaScript/Obsolete_Pages/Obsolete_Pages/Obsolete_Pages/職員的例子/物件的屬性/屬性的繼承	/zh-TW/docs/Web/JavaScript/Inheritance_and_the_prototype_chain
/zh-TW/docs/JavaScript/Obsolete_Pages/Obsolete_Pages/Obsolete_Pages/表達式	/zh-TW/docs/Web/JavaScript/Guide/Expressions_and_operators
/zh-TW/docs/JavaScript/Obsolete_Pages/Obsolete_Pages/Obsolete_Pages/註解	/zh-TW/docs/Web/JavaScript/Guide/Control_flow_and_error_handling
/zh-TW/docs/JavaScript/Obsolete_Pages/Obsolete_Pages/Obsolete_Pages/變數	/zh-TW/docs/Web/JavaScript/Guide/Grammar_and_types
/zh-TW/docs/JavaScript/Obsolete_Pages/Obsolete_Pages/Obsolete_Pages/運算子	/zh-TW/docs/Web/JavaScript/Guide/Expressions_and_operators
/zh-TW/docs/JavaScript/Obsolete_Pages/Obsolete_Pages/Obsolete_Pages/運算子/代入運算子	/zh-TW/docs/Web/JavaScript/Guide/Expressions_and_operators
/zh-TW/docs/JavaScript/Obsolete_Pages/Obsolete_Pages/Obsolete_Pages/運算子/位元運算子	/zh-TW/docs/Web/JavaScript/Guide/Expressions_and_operators
/zh-TW/docs/JavaScript/Obsolete_Pages/Obsolete_Pages/Obsolete_Pages/運算子/字串運算子	/zh-TW/docs/Web/JavaScript/Guide/Expressions_and_operators
/zh-TW/docs/JavaScript/Obsolete_Pages/Obsolete_Pages/Obsolete_Pages/運算子/特殊運算子	/zh-TW/docs/Web/JavaScript/Guide/Expressions_and_operators
/zh-TW/docs/JavaScript/Obsolete_Pages/Obsolete_Pages/Obsolete_Pages/運算子/算術運算子	/zh-TW/docs/Web/JavaScript/Guide/Expressions_and_operators
/zh-TW/docs/JavaScript/Obsolete_Pages/Obsolete_Pages/Obsolete_Pages/運算子/邏輯運算子	/zh-TW/docs/Web/JavaScript/Guide/Expressions_and_operators
/zh-TW/docs/JavaScript/Obsolete_Pages/Obsolete_Pages/Obsolete_Pages/閉包的運用	/zh-TW/docs/Web/JavaScript/Closures
/zh-TW/docs/JavaScript/Obsolete_Pages/Obsolete_Pages/Obsolete_Pages/關於	/zh-TW/docs/Web/JavaScript/Guide/Introduction
/zh-TW/docs/JavaScript/Obsolete_Pages/Obsolete_Pages/Obsolete_Pages/陣列的運用	/zh-TW/docs/Web/JavaScript/Guide
/zh-TW/docs/JavaScript/Obsolete_Pages/Obsolete_Pages/Obsolete_Pages/預先定義的函數	/zh-TW/docs/Web/JavaScript/Guide/Functions
/zh-TW/docs/JavaScript/Obsolete_Pages/Obsolete_Pages/Obsolete_Pages/預先定義的函數/Number_和_String_函數	/zh-TW/docs/Web/JavaScript/Guide/Functions
/zh-TW/docs/JavaScript/Obsolete_Pages/Obsolete_Pages/Obsolete_Pages/預先定義的函數/escape_和_unescape_函數	/zh-TW/docs/Web/JavaScript/Guide/Functions
/zh-TW/docs/JavaScript/Obsolete_Pages/Obsolete_Pages/Obsolete_Pages/預先定義的函數/eval_函數	/zh-TW/docs/Web/JavaScript/Guide/Functions
/zh-TW/docs/JavaScript/Obsolete_Pages/Obsolete_Pages/Obsolete_Pages/預先定義的函數/isFinite_函數	/zh-TW/docs/Web/JavaScript/Guide/Functions
/zh-TW/docs/JavaScript/Obsolete_Pages/Obsolete_Pages/Obsolete_Pages/預先定義的函數/isNaN_函數	/zh-TW/docs/Web/JavaScript/Guide/Functions
/zh-TW/docs/JavaScript/Obsolete_Pages/Obsolete_Pages/Obsolete_Pages/預先定義的核心物件	/zh-TW/docs/Web/JavaScript/Guide
/zh-TW/docs/JavaScript/Same_origin_policy_for_JavaScript	/zh-TW/docs/Web/Security/Same-origin_policy
/zh-TW/docs/JavaScript_technologies_overview	/zh-TW/docs/Web/JavaScript/JavaScript_technologies_overview
/zh-TW/docs/JavaScript_technologies_overview-redirect-1	/zh-TW/docs/Web/JavaScript/JavaScript_technologies_overview
/zh-TW/docs/JavaScript_typed_arrays	/zh-TW/docs/Web/JavaScript/Guide/Typed_arrays
/zh-TW/docs/JavaScript_技術簡介	/zh-TW/docs/Web/JavaScript/JavaScript_technologies_overview
/zh-TW/docs/JavaScript_正規表達式	/zh-TW/docs/Web/JavaScript/Guide/Regular_expressions
/zh-TW/docs/JavaScript_物件導向介紹	/zh-TW/docs/Learn/JavaScript/Objects
/zh-TW/docs/JavaScript_語言的資源	/zh-TW/docs/Web/JavaScript/JavaScript_technologies_overview
/zh-TW/docs/Learn/CSS/Getting_started	/en-US/docs/Learn/CSS/First_steps
/zh-TW/docs/Learn/CSS/Getting_started/Layout	/zh-TW/docs/Learn/CSS/CSS_layout
/zh-TW/docs/Learn/CSS/Getting_started/What_is_CSS	/en-US/docs/Learn/CSS/First_steps/How_CSS_works
/zh-TW/docs/Learn/CSS/Getting_started/Why_use_CSS	/en-US/docs/Learn/CSS/First_steps/How_CSS_works
/zh-TW/docs/Learn/CSS/Introduction_to_CSS	/en-US/docs/Learn/CSS/First_steps
/zh-TW/docs/Learn/CSS/Introduction_to_CSS/How_CSS_works	/en-US/docs/Learn/CSS/First_steps/How_CSS_works
/zh-TW/docs/Learn/CSS/Introduction_to_CSS/Layout	/zh-TW/docs/Learn/CSS/CSS_layout
/zh-TW/docs/Learn/CSS/Introduction_to_CSS/Selectors	/en-US/docs/Learn/CSS/Building_blocks/Selectors
/zh-TW/docs/Learn/CSS/Introduction_to_CSS/Syntax	/en-US/docs/Learn/CSS/First_steps/How_CSS_is_structured
/zh-TW/docs/Learn/CSS/Introduction_to_CSS/What_is_CSS	/en-US/docs/Learn/CSS/First_steps/How_CSS_works
/zh-TW/docs/Learn/CSS/Introduction_to_CSS/Why_use_CSS	/en-US/docs/Learn/CSS/First_steps/How_CSS_works
/zh-TW/docs/Learn/CSS/Styling_boxes	/en-US/docs/Learn/CSS/Building_blocks
/zh-TW/docs/Learn/CSS/文字樣式	/zh-TW/docs/Learn/CSS/Styling_text
/zh-TW/docs/Learn/CSS/樣式化容器	/en-US/docs/Learn/CSS/Building_blocks
/zh-TW/docs/Learn/Common_questions/What_is_a_web_server	/zh-TW/docs/Learn/Common_questions/Web_mechanics/What_is_a_web_server
/zh-TW/docs/Learn/HTML/Forms	/zh-TW/docs/Learn/Forms
/zh-TW/docs/Learn/HTML/Forms/How_to_structure_an_HTML_form	/zh-TW/docs/Learn/Forms/How_to_structure_a_web_form
/zh-TW/docs/Learn/HTML/HTML介紹	/zh-TW/docs/Learn/HTML/Introduction_to_HTML
/zh-TW/docs/Learn/HTML/Multimedia_and_embedding/HTML中的圖片	/zh-TW/docs/Learn/HTML/Multimedia_and_embedding/Images_in_HTML
/zh-TW/docs/Learn/HTML/Tables/基礎	/zh-TW/docs/Learn/HTML/Tables/Basics
/zh-TW/docs/Learn/How_to_contribute	/zh-TW/docs/MDN/Community/Contributing
/zh-TW/docs/Learn/JavaScript/Asynchronous/Choosing_the_right_approach	/zh-TW/docs/Learn/JavaScript/Asynchronous
/zh-TW/docs/Learn/JavaScript/Asynchronous/Concepts	/zh-TW/docs/Learn/JavaScript/Asynchronous/Introducing
/zh-TW/docs/Learn/JavaScript/Asynchronous/Timeouts_and_intervals	/zh-TW/docs/Learn/JavaScript/Asynchronous
/zh-TW/docs/Learn/JavaScript/Building_blocks/函數	/zh-TW/docs/Learn/JavaScript/Building_blocks/Functions
/zh-TW/docs/Learn/JavaScript/Building_blocks/循環代碼	/zh-TW/docs/Learn/JavaScript/Building_blocks/Looping_code
/zh-TW/docs/Learn/JavaScript/First_steps/傻故事產生器	/zh-TW/docs/Learn/JavaScript/First_steps/Silly_story_generator
/zh-TW/docs/Learn/JavaScript/First_steps/初次接觸	/zh-TW/docs/Learn/JavaScript/First_steps/A_first_splash
/zh-TW/docs/Learn/JavaScript/First_steps/字符串	/zh-TW/docs/Learn/JavaScript/First_steps/Strings
/zh-TW/docs/Learn/JavaScript/First_steps/有用的字符串方法	/zh-TW/docs/Learn/JavaScript/First_steps/Useful_string_methods
/zh-TW/docs/Learn/JavaScript/First_steps/變數	/zh-TW/docs/Learn/JavaScript/First_steps/Variables
/zh-TW/docs/Learn/JavaScript/First_steps/陣列	/zh-TW/docs/Learn/JavaScript/First_steps/Arrays
/zh-TW/docs/Learn/JavaScript/Objects/Inheritance	/zh-TW/docs/Learn/JavaScript/Objects/Classes_in_JavaScript
/zh-TW/docs/Learn/JavaScript/Objects/Object-oriented_JS	/zh-TW/docs/Learn/JavaScript/Objects/Classes_in_JavaScript
/zh-TW/docs/Learn/JavaScript/如何運用	/zh-TW/docs/Learn/JavaScript/Howto
/zh-TW/docs/Learn/JavaScript/第一步	/zh-TW/docs/Learn/JavaScript/First_steps
/zh-TW/docs/Learn/Server-side/Express_Nodejs/Displaying_data/flow_control_using_async	/zh-TW/docs/Learn/Server-side/Express_Nodejs/Displaying_data
/zh-TW/docs/Learn/Server-side/First_steps/介紹	/zh-TW/docs/Learn/Server-side/First_steps/Introduction
/zh-TW/docs/MDN/About	/zh-TW/docs/MDN/Writing_guidelines
/zh-TW/docs/MDN/Community/論壇	/en-US/docs/MDN/Community
/zh-TW/docs/MDN/Contribute	/zh-TW/docs/MDN/Community/Contributing
/zh-TW/docs/MDN/Contribute/Content	/zh-TW/docs/MDN/Writing_guidelines
/zh-TW/docs/MDN/Contribute/Content/Style_guide	/zh-TW/docs/MDN/Writing_guidelines/Writing_style_guide
/zh-TW/docs/MDN/Contribute/Getting_started	/zh-TW/docs/MDN/Community/Contributing/Getting_started
/zh-TW/docs/MDN/Contribute/Guidelines	/zh-TW/docs/MDN/Writing_guidelines
/zh-TW/docs/MDN/Contribute/Guidelines/Style_guide	/zh-TW/docs/MDN/Writing_guidelines/Writing_style_guide
/zh-TW/docs/MDN/Contribute/Guidelines/Writing_style_guide	/zh-TW/docs/MDN/Writing_guidelines/Writing_style_guide
/zh-TW/docs/MDN/Contribute/Howto	/zh-TW/docs/MDN/Community/Contributing
/zh-TW/docs/MDN/Contribute/Howto/Create_an_MDN_account	/zh-TW/docs/MDN/Community/Contributing
/zh-TW/docs/MDN/Contribute/Howto/Do_a_technical_review	/zh-TW/docs/MDN/Community/Contributing
/zh-TW/docs/MDN/Contribute/Howto/Do_an_editorial_review	/zh-TW/docs/MDN/Community/Contributing
/zh-TW/docs/MDN/Contribute/Howto/Set_the_summary_for_a_page	/zh-TW/docs/MDN/Community/Contributing
/zh-TW/docs/MDN/Contribute/Howto/編輯審查	/zh-TW/docs/MDN/Community/Contributing
/zh-TW/docs/MDN/Contribute/Tools	https://github.com/mdn/yari/tree/main/docs
/zh-TW/docs/MDN/Contribute/Tools/KumaScript	https://github.com/mdn/yari/tree/main/docs/kumascript
/zh-TW/docs/MDN/Contribute/Tools/KumaScript/Troubleshooting	https://github.com/mdn/yari/tree/main/docs/kumascript/troubleshooting-errors.md
/zh-TW/docs/MDN/Getting_started	/zh-TW/docs/MDN/Community/Contributing/Getting_started
/zh-TW/docs/MDN/Guidelines	/zh-TW/docs/MDN/Writing_guidelines
/zh-TW/docs/MDN/Guidelines/Writing_style_guide	/zh-TW/docs/MDN/Writing_guidelines/Writing_style_guide
/zh-TW/docs/MDN/Kuma	https://github.com/mdn/yari/tree/main/docs/what-yari-does.md
/zh-TW/docs/MDN/Kuma/Troubleshooting_KumaScript_errors	https://github.com/mdn/yari/tree/main/docs/kumascript/troubleshooting-errors.md
/zh-TW/docs/MDN/Tools	https://github.com/mdn/yari/tree/main/docs
/zh-TW/docs/MDN/Tools/KumaScript	https://github.com/mdn/yari/tree/main/docs/kumascript
/zh-TW/docs/MDN/Tools/KumaScript/Troubleshooting	https://github.com/mdn/yari/tree/main/docs/kumascript/troubleshooting-errors.md
/zh-TW/docs/MDN/Yari	https://github.com/mdn/yari/tree/main/docs/what-yari-does.md
/zh-TW/docs/MDN_at_ten	/zh-TW/docs/MDN/At_ten
/zh-TW/docs/Mozilla/Add-ons/WebExtensions/Porting_from_Google_Chrome	https://extensionworkshop.com/documentation/develop/porting-a-google-chrome-extension/
/zh-TW/docs/Mozilla/Add-ons/WebExtensions/manifest.json/applications	/zh-TW/docs/Mozilla/Add-ons/WebExtensions/manifest.json/browser_specific_settings
/zh-TW/docs/Mozilla/Add-ons/WebExtensions/manifest.json/作者	/zh-TW/docs/Mozilla/Add-ons/WebExtensions/manifest.json/author
/zh-TW/docs/Mozilla/Add-ons/WebExtensions/user_interface/Browser_action	/zh-TW/docs/Mozilla/Add-ons/WebExtensions/user_interface/Toolbar_button
/zh-TW/docs/Mozilla/Add-ons/WebExtensions/user_interface/側邊欄	/zh-TW/docs/Mozilla/Add-ons/WebExtensions/user_interface/Sidebars
/zh-TW/docs/Mozilla/Add-ons/WebExtensions/user_interface/工具列按鈕	/zh-TW/docs/Mozilla/Add-ons/WebExtensions/user_interface/Toolbar_button
/zh-TW/docs/Mozilla/Add-ons/WebExtensions/user_interface/快捷選單項	/zh-TW/docs/Mozilla/Add-ons/WebExtensions/user_interface/Context_menu_items
/zh-TW/docs/Mozilla/Add-ons/WebExtensions/user_interface/開發工具面板	/zh-TW/docs/Mozilla/Add-ons/WebExtensions/user_interface/devtools_panels
/zh-TW/docs/Mozilla/Add-ons/WebExtensions/用戶介面	/zh-TW/docs/Mozilla/Add-ons/WebExtensions/user_interface
/zh-TW/docs/Mozilla/Add-ons/WebExtensions/用戶介面/側邊欄	/zh-TW/docs/Mozilla/Add-ons/WebExtensions/user_interface/Sidebars
/zh-TW/docs/Mozilla/Add-ons/WebExtensions/用戶介面/工具列按鈕	/zh-TW/docs/Mozilla/Add-ons/WebExtensions/user_interface/Toolbar_button
/zh-TW/docs/Mozilla/Add-ons/WebExtensions/用戶介面/快捷選單項	/zh-TW/docs/Mozilla/Add-ons/WebExtensions/user_interface/Context_menu_items
/zh-TW/docs/Mozilla/Add-ons/WebExtensions/用戶介面/開發工具面板	/zh-TW/docs/Mozilla/Add-ons/WebExtensions/user_interface/devtools_panels
/zh-TW/docs/Mozilla/Add-ons/WebExtensions/用戶體驗最佳實踐	https://extensionworkshop.com/documentation/develop/user-experience-best-practices/
/zh-TW/docs/Mozilla/Firefox/Releases/2/Firefox_2_的安全功能	/zh-TW/docs/Mozilla/Firefox/Releases/2/Security_changes
/zh-TW/docs/Mozilla/Firefox/Releases/2/新增消息來源閱讀工具	/zh-TW/docs/Mozilla/Firefox/Releases/2/Adding_feed_readers_to_Firefox
/zh-TW/docs/Mozilla/Firefox/Releases/3/Firefox_3_Dom_Improvements	/zh-TW/docs/Mozilla/Firefox/Releases/3/DOM_improvements
/zh-TW/docs/Mozilla_event_reference	/zh-TW/docs/Web/Events
/zh-TW/docs/Python	/zh-TW/docs/Learn/Server-side/Django
/zh-TW/docs/Quirks_Mode_and_Standards_Mode	/zh-TW/docs/Web/HTML/Quirks_Mode_and_Standards_Mode
/zh-TW/docs/SVG	/zh-TW/docs/Web/SVG
/zh-TW/docs/SVG/Tutorial	/zh-TW/docs/Web/SVG/Tutorial
/zh-TW/docs/SVG/Tutorial/Basic_Shapes	/zh-TW/docs/Web/SVG/Tutorial/Basic_Shapes
/zh-TW/docs/SVG/Tutorial/Introduction	/zh-TW/docs/Web/SVG/Tutorial/Introduction
/zh-TW/docs/SVG/Tutorial/Positions	/zh-TW/docs/Web/SVG/Tutorial/Positions
/zh-TW/docs/SVG/Tutorial/入门	/zh-TW/docs/Web/SVG/Tutorial/Getting_Started
/zh-TW/docs/SVG/Tutorial/图案	/zh-TW/docs/Web/SVG/Tutorial/Patterns
/zh-TW/docs/SVG/Tutorial/基本形状	/zh-TW/docs/Web/SVG/Tutorial/Basic_Shapes
/zh-TW/docs/SVG/Tutorial/填充与边框	/zh-TW/docs/Web/SVG/Tutorial/Fills_and_Strokes
/zh-TW/docs/SVG/Tutorial/渐变	/zh-TW/docs/Web/SVG/Tutorial/Gradients
/zh-TW/docs/SVG/教學	/zh-TW/docs/Web/SVG/Tutorial
/zh-TW/docs/Security/MixedContent	/zh-TW/docs/Web/Security/Mixed_content
/zh-TW/docs/Security/弱簽章演算法	/zh-TW/docs/Web/Security/Weak_Signature_Algorithm
/zh-TW/docs/Security/缺少安全性的密碼	/zh-TW/docs/Web/Security/Insecure_passwords
/zh-TW/docs/Tools	https://firefox-source-docs.mozilla.org/devtools-user/index.html
/zh-TW/docs/Tools/3D_View	https://firefox-source-docs.mozilla.org/devtools-user/3d_view/index.html
/zh-TW/docs/Tools/Browser_Toolbox	https://firefox-source-docs.mozilla.org/devtools-user/browser_toolbox/index.html
/zh-TW/docs/Tools/Debugger	https://firefox-source-docs.mozilla.org/devtools-user/debugger/index.html
/zh-TW/docs/Tools/Debugger/How_to	https://firefox-source-docs.mozilla.org/devtools-user/debugger/how_to/index.html
/zh-TW/docs/Tools/Debugger/How_to/Open_the_debugger	https://firefox-source-docs.mozilla.org/devtools-user/debugger/how_to/open_the_debugger/index.html
/zh-TW/docs/Tools/Debugger/How_to/Set_a_breakpoint	https://firefox-source-docs.mozilla.org/devtools-user/debugger/how_to/set_a_breakpoint/index.html
/zh-TW/docs/Tools/Network_Monitor	https://firefox-source-docs.mozilla.org/devtools-user/network_monitor/index.html
/zh-TW/docs/Tools/Page_Inspector	https://firefox-source-docs.mozilla.org/devtools-user/page_inspector/index.html
/zh-TW/docs/Tools/Page_Inspector/How_to	https://firefox-source-docs.mozilla.org/devtools-user/page_inspector/how_to/index.html
/zh-TW/docs/Tools/Page_Inspector/How_to/Examine_grid_layouts	https://firefox-source-docs.mozilla.org/devtools-user/page_inspector/how_to/examine_grid_layouts/index.html
/zh-TW/docs/Tools/Performance	https://firefox-source-docs.mozilla.org/devtools-user/performance/index.html
/zh-TW/docs/Tools/Performance/Allocations	https://profiler.firefox.com/docs/
/zh-TW/docs/Tools/Performance/Frame_rate	https://profiler.firefox.com/docs/
/zh-TW/docs/Tools/Remote_Debugging	https://profiler.firefox.com/docs/
/zh-TW/docs/Tools/Remote_Debugging/Firefox_for_Android	https://profiler.firefox.com/docs/
/zh-TW/docs/Tools/Responsive_Design_Mode	https://firefox-source-docs.mozilla.org/devtools-user/responsive_design_mode/index.html
/zh-TW/docs/Tools/Settings	https://firefox-source-docs.mozilla.org/devtools-user/settings/index.html
/zh-TW/docs/Tools/Style_Editor	https://firefox-source-docs.mozilla.org/devtools-user/style_editor/index.html
/zh-TW/docs/Tools/Web_Audio_Editor	https://firefox-source-docs.mozilla.org/devtools-user/web_audio_editor/index.html
/zh-TW/docs/Tools/Web_Console	https://firefox-source-docs.mozilla.org/devtools-user/web_console/index.html
/zh-TW/docs/Tools/Web_Console/Console_messages	https://firefox-source-docs.mozilla.org/devtools-user/web_console/console_messages/index.html
/zh-TW/docs/Tools/Web_Console/Keyboard_shortcuts	https://firefox-source-docs.mozilla.org/devtools-user/keyboard_shortcuts/index.html#web_console
/zh-TW/docs/Tools/Web_Console/Opening_the_Web_Console	https://firefox-source-docs.mozilla.org/devtools-user/web_console/ui_tour/index.html
/zh-TW/docs/Tools/Web_Console/Rich_output	https://firefox-source-docs.mozilla.org/devtools-user/web_console/rich_output/index.html
/zh-TW/docs/Tools/Web_Console/Split_console	https://firefox-source-docs.mozilla.org/devtools-user/web_console/split_console/index.html
/zh-TW/docs/Tools/Web_Console/The_command_line_interpreter	https://firefox-source-docs.mozilla.org/devtools-user/web_console/the_command_line_interpreter/index.html
/zh-TW/docs/Tools/Web_Console/UI_Tour	https://firefox-source-docs.mozilla.org/devtools-user/web_console/ui_tour/index.html
/zh-TW/docs/Using_files_from_web_applications	/zh-TW/docs/Web/API/File_API/Using_files_from_web_applications
/zh-TW/docs/Using_geolocation	/zh-TW/docs/Web/API/Geolocation_API
/zh-TW/docs/Web/API/Ambient_Light_Events	/en-US/docs/Web/API/AmbientLightSensor
/zh-TW/docs/Web/API/Canvas_API/Drawing_graphics_with_canvas	/zh-TW/docs/Web/API/Canvas_API/Tutorial
/zh-TW/docs/Web/API/Canvas_API/Tutorial/基礎動畫	/zh-TW/docs/Web/API/Canvas_API/Tutorial/Basic_animations
/zh-TW/docs/Web/API/Canvas_API/Tutorial/最佳化_canvas	/zh-TW/docs/Web/API/Canvas_API/Tutorial/Optimizing_canvas
/zh-TW/docs/Web/API/Coordinates	/zh-TW/docs/Web/API/GeolocationCoordinates
/zh-TW/docs/Web/API/Coordinates/accuracy	/zh-TW/docs/Web/API/GeolocationCoordinates/accuracy
/zh-TW/docs/Web/API/Coordinates/altitude	/zh-TW/docs/Web/API/GeolocationCoordinates/altitude
/zh-TW/docs/Web/API/Coordinates/altitudeAccuracy	/zh-TW/docs/Web/API/GeolocationCoordinates/altitudeAccuracy
/zh-TW/docs/Web/API/Coordinates/heading	/zh-TW/docs/Web/API/GeolocationCoordinates/heading
/zh-TW/docs/Web/API/Coordinates/latitude	/zh-TW/docs/Web/API/GeolocationCoordinates/latitude
/zh-TW/docs/Web/API/Coordinates/longitude	/zh-TW/docs/Web/API/GeolocationCoordinates/longitude
/zh-TW/docs/Web/API/Coordinates/speed	/zh-TW/docs/Web/API/GeolocationCoordinates/speed
/zh-TW/docs/Web/API/Document/registerElement	/zh-TW/docs/Web/API/CustomElementRegistry/define
/zh-TW/docs/Web/API/Document_Object_Model/Events	/zh-TW/docs/Web/API/Event
/zh-TW/docs/Web/API/Document_Object_Model/Whitespace_in_the_DOM	/zh-TW/docs/Web/API/Document_Object_Model/Whitespace
/zh-TW/docs/Web/API/Document_Object_Model/事件	/zh-TW/docs/Web/API/Event
/zh-TW/docs/Web/API/ElementCSSInlineStyle/style	/en-US/docs/Web/API/HTMLElement/style
/zh-TW/docs/Web/API/EventListener	/zh-TW/docs/Web/API/EventTarget/addEventListener
/zh-TW/docs/Web/API/File/Using_files_from_web_applications	/zh-TW/docs/Web/API/File_API/Using_files_from_web_applications
/zh-TW/docs/Web/API/File/fileName	/zh-TW/docs/Web/API/File/name
/zh-TW/docs/Web/API/File_Handle_API	/zh-TW/docs/Web/API/File_and_Directory_Entries_API
/zh-TW/docs/Web/API/Geolocation/Using_geolocation	/zh-TW/docs/Web/API/Geolocation_API
/zh-TW/docs/Web/API/GlobalEventHandlers/onclose	/zh-TW/docs/Web/API/HTMLDialogElement/close_event
/zh-TW/docs/Web/API/HTMLOrForeignElement/dataset	/en-US/docs/Web/API/HTMLElement/dataset
/zh-TW/docs/Web/API/IndexedDB_API/Basic_Concepts_Behind_IndexedDB	/zh-TW/docs/Web/API/IndexedDB_API
/zh-TW/docs/Web/API/Media_Streams_API	/zh-TW/docs/Web/API/Media_Capture_and_Streams_API
/zh-TW/docs/Web/API/Navigator/registerProtocolHandler/Web-based_protocol_handlers	/zh-TW/docs/Web/API/Navigator/registerProtocolHandler
/zh-TW/docs/Web/API/NavigatorOnLine	/en-US/docs/Web/API/Navigator/onLine
/zh-TW/docs/Web/API/NavigatorOnLine/Online_and_offline_events	/en-US/docs/Web/API/Navigator/onLine
/zh-TW/docs/Web/API/ParentNode/children	/en-US/docs/Web/API/Element/children
/zh-TW/docs/Web/API/ParentNode/firstElementChild	/en-US/docs/Web/API/Element/firstElementChild
/zh-TW/docs/Web/API/Position	/zh-TW/docs/Web/API/GeolocationPosition
/zh-TW/docs/Web/API/Position/coords	/zh-TW/docs/Web/API/GeolocationPosition/coords
/zh-TW/docs/Web/API/Position/timestamp	/zh-TW/docs/Web/API/GeolocationPosition/timestamp
/zh-TW/docs/Web/API/PositionError	/zh-TW/docs/Web/API/GeolocationPositionError
/zh-TW/docs/Web/API/PositionError/code	/zh-TW/docs/Web/API/GeolocationPositionError/code
/zh-TW/docs/Web/API/PositionError/message	/zh-TW/docs/Web/API/GeolocationPositionError/message
/zh-TW/docs/Web/API/PositionOptions	/zh-TW/docs/Web/API/Geolocation/getCurrentPosition
/zh-TW/docs/Web/API/PositionOptions/enableHighAccuracy	/zh-TW/docs/Web/API/Geolocation/getCurrentPosition
/zh-TW/docs/Web/API/PositionOptions/maximumAge	/zh-TW/docs/Web/API/Geolocation/getCurrentPosition
/zh-TW/docs/Web/API/PositionOptions/timeout	/zh-TW/docs/Web/API/Geolocation/getCurrentPosition
/zh-TW/docs/Web/API/Web_Video_Text_Tracks_Format	/zh-TW/docs/Web/API/WebVTT_API
/zh-TW/docs/Web/API/Window/sidebar/Adding_search_engines_from_Web_pages	/zh-TW/docs/Web/OpenSearch
/zh-TW/docs/Web/API/WindowOrWorkerGlobalScope/setInterval	/zh-TW/docs/Web/API/Window/setInterval
/zh-TW/docs/Web/API/XMLHttpRequest/FormData	/zh-TW/docs/Web/API/FormData
/zh-TW/docs/Web/API/XMLHttpRequest/Using_XMLHttpRequest	/zh-TW/docs/Web/API/XMLHttpRequest_API/Using_XMLHttpRequest
/zh-TW/docs/Web/API/console/assert	/zh-TW/docs/Web/API/console/assert_static
/zh-TW/docs/Web/API/setInterval	/zh-TW/docs/Web/API/Window/setInterval
/zh-TW/docs/Web/Apps/Progressive	/zh-TW/docs/Web/Progressive_web_apps
/zh-TW/docs/Web/CSS/-moz-border-image	/zh-TW/docs/Web/CSS/border-image
/zh-TW/docs/Web/CSS/@viewport	/zh-TW/docs/Web/CSS
/zh-TW/docs/Web/CSS/@viewport/height	/zh-TW/docs/Web/CSS
/zh-TW/docs/Web/CSS/CSS_Flexible_Box_Layout/Using_CSS_flexible_boxes	/zh-TW/docs/Web/CSS/CSS_flexible_box_layout/Basic_concepts_of_flexbox
/zh-TW/docs/Web/CSS/CSS_一般問題	/zh-TW/docs/Learn/CSS/Howto/CSS_FAQ
/zh-TW/docs/Web/CSS/CSS_網格_布局	/zh-TW/docs/Web/CSS/CSS_grid_layout
/zh-TW/docs/Web/CSS/Common_CSS_Questions	/zh-TW/docs/Learn/CSS/Howto/CSS_FAQ
/zh-TW/docs/Web/CSS/Descendant_selectors	/zh-TW/docs/Web/CSS/Descendant_combinator
/zh-TW/docs/Web/CSS/border-image/border-image	/zh-TW/docs/Web/CSS/border-image
/zh-TW/docs/Web/CSS/彈頭	/zh-TW/docs/Web/CSS/box-sizing
/zh-TW/docs/Web/CSS/繼承	/zh-TW/docs/Web/CSS/Inheritance
/zh-TW/docs/Web/CSS/語法	/zh-TW/docs/Web/CSS/Syntax
/zh-TW/docs/Web/Guide/AJAX	/zh-TW/docs/Learn/JavaScript/Client-side_web_APIs/Fetching_data
/zh-TW/docs/Web/Guide/AJAX/Getting_Started	/zh-TW/docs/Learn/JavaScript/Client-side_web_APIs/Fetching_data
/zh-TW/docs/Web/Guide/API/DOM/Manipulating_the_browser_history/Manipulating_the_browser_history	/zh-TW/docs/Web/API/History_API
/zh-TW/docs/Web/Guide/CSS	/zh-TW/docs/Learn/CSS
/zh-TW/docs/Web/Guide/CSS/Getting_started	/en-US/docs/Learn/CSS/First_steps
/zh-TW/docs/Web/Guide/CSS/Getting_started/Layout	/zh-TW/docs/Learn/CSS/CSS_layout
/zh-TW/docs/Web/Guide/CSS/Getting_started/What_is_CSS	/en-US/docs/Learn/CSS/First_steps/How_CSS_works
/zh-TW/docs/Web/Guide/CSS/Getting_started/Why_use_CSS	/en-US/docs/Learn/CSS/First_steps/How_CSS_works
/zh-TW/docs/Web/Guide/CSS/Getting_started/為什麼要用CSS	/en-US/docs/Learn/CSS/First_steps/How_CSS_works
/zh-TW/docs/Web/Guide/DOM	/zh-TW/docs/Web/API/Document_Object_Model
/zh-TW/docs/Web/Guide/DOM/Manipulating_the_browser_history	/zh-TW/docs/Web/API/History_API
/zh-TW/docs/Web/Guide/DOM/Using_full_screen_mode	/zh-TW/docs/Web/API/Fullscreen_API
/zh-TW/docs/Web/Guide/Events	/zh-TW/docs/Web/Events
/zh-TW/docs/Web/Guide/Events/Creating_and_triggering_events	/zh-TW/docs/Web/Events/Creating_and_triggering_events
/zh-TW/docs/Web/Guide/Events/Event_handlers	/zh-TW/docs/Web/Events/Event_handlers
/zh-TW/docs/Web/Guide/Graphics	/zh-TW/docs/Learn/HTML/Multimedia_and_embedding/Images_in_HTML
/zh-TW/docs/Web/Guide/HTML	/zh-TW/docs/Learn/HTML
/zh-TW/docs/Web/Guide/HTML/Canvas_tutorial	/zh-TW/docs/Web/API/Canvas_API/Tutorial
/zh-TW/docs/Web/Guide/HTML/Canvas_tutorial/Applying_styles_and_colors	/zh-TW/docs/Web/API/Canvas_API/Tutorial/Applying_styles_and_colors
/zh-TW/docs/Web/Guide/HTML/Canvas_tutorial/Basic_usage	/zh-TW/docs/Web/API/Canvas_API/Tutorial/Basic_usage
/zh-TW/docs/Web/Guide/HTML/Canvas_tutorial/Compositing	/zh-TW/docs/Web/API/Canvas_API/Tutorial/Compositing
/zh-TW/docs/Web/Guide/HTML/Canvas_tutorial/Drawing_shapes	/zh-TW/docs/Web/API/Canvas_API/Tutorial/Drawing_shapes
/zh-TW/docs/Web/Guide/HTML/Canvas_tutorial/Transformations	/zh-TW/docs/Web/API/Canvas_API/Tutorial/Transformations
/zh-TW/docs/Web/Guide/HTML/Canvas_tutorial/Using_images	/zh-TW/docs/Web/API/Canvas_API/Tutorial/Using_images
/zh-TW/docs/Web/Guide/HTML/Canvas_tutorial/基礎動畫	/zh-TW/docs/Web/API/Canvas_API/Tutorial/Basic_animations
/zh-TW/docs/Web/Guide/HTML/Canvas_tutorial/最佳化_canvas	/zh-TW/docs/Web/API/Canvas_API/Tutorial/Optimizing_canvas
/zh-TW/docs/Web/Guide/HTML/Content_categories	/zh-TW/docs/Web/HTML/Content_categories
/zh-TW/docs/Web/Guide/HTML/Drag_and_drop	/zh-TW/docs/Web/API/HTML_Drag_and_Drop_API
/zh-TW/docs/Web/Guide/HTML/Drag_operations	/zh-TW/docs/Web/API/HTML_Drag_and_Drop_API/Drag_operations
/zh-TW/docs/Web/Guide/HTML/Forms	/zh-TW/docs/Learn/Forms
/zh-TW/docs/Web/Guide/HTML/Forms/How_to_structure_an_HTML_form	/zh-TW/docs/Learn/Forms/How_to_structure_a_web_form
/zh-TW/docs/Web/Guide/HTML/HTML5	/zh-TW/docs/Glossary/HTML5
/zh-TW/docs/Web/Guide/HTML/HTML5/Introduction_to_HTML5	/zh-TW/docs/Learn/HTML
/zh-TW/docs/Web/Guide/Introduction_to_Web_development	/zh-TW/docs/Learn
/zh-TW/docs/Web/Guide/WOFF	/zh-TW/docs/Web/CSS/CSS_fonts/WOFF
/zh-TW/docs/Web/Guide/Writing_forward-compatible_websites	/zh-TW/docs/Learn/Tools_and_testing/Cross_browser_testing/JavaScript
/zh-TW/docs/Web/Guide/圖像	/zh-TW/docs/Learn/HTML/Multimedia_and_embedding/Images_in_HTML
/zh-TW/docs/Web/HTML/Block-level_elements	/zh-TW/docs/Glossary/Block-level_content
/zh-TW/docs/Web/HTML/Canvas	/zh-TW/docs/Web/API/Canvas_API
/zh-TW/docs/Web/HTML/Canvas/Drawing_graphics_with_canvas	/zh-TW/docs/Web/API/Canvas_API/Tutorial
/zh-TW/docs/Web/HTML/Forms_in_HTML	/zh-TW/docs/Learn/Forms
/zh-TW/docs/Web/HTML/HTML5	/zh-TW/docs/Glossary/HTML5
/zh-TW/docs/Web/HTML/HTML5/Introduction_to_HTML5	/zh-TW/docs/Learn/HTML
/zh-TW/docs/Web/HTML/HTML5_表單	/zh-TW/docs/Learn/Forms
/zh-TW/docs/Web/HTML/Introduction	/zh-CN/docs/learn/HTML/Introduction_to_HTML
/zh-TW/docs/Web/HTML/區塊級元素	/zh-TW/docs/Glossary/Block-level_content
/zh-TW/docs/Web/HTTP/Access_control_CORS	/zh-TW/docs/Web/HTTP/CORS
/zh-TW/docs/Web/HTTP/Basics_of_HTTP/Choosing_between_www_and_non-www_URLs	/zh-TW/docs/Web/URI/Authority/Choosing_between_www_and_non-www_URLs
/zh-TW/docs/Web/HTTP/Basics_of_HTTP/Data_URLs	/zh-TW/docs/Web/URI/Schemes/data
/zh-TW/docs/Web/HTTP/Link_prefetching_FAQ	/zh-TW/docs/Glossary/Prefetch
/zh-TW/docs/Web/HTTP/Response_codes	/zh-TW/docs/Web/HTTP/Status
/zh-TW/docs/Web/HTTP/Server-Side_Access_Control	/zh-TW/docs/Web/HTTP/CORS
/zh-TW/docs/Web/HTTP/Status/418_I_m_a_teapot	/zh-TW/docs/Web/HTTP/Status/418
/zh-TW/docs/Web/HTTP/X-Frame-Options	/zh-TW/docs/Web/HTTP/Headers/X-Frame-Options
/zh-TW/docs/Web/JavaScript/A_re-introduction_to_JavaScript	/zh-TW/docs/Web/JavaScript/Language_overview
/zh-TW/docs/Web/JavaScript/About_JavaScript	/zh-TW/docs/Web/JavaScript
/zh-TW/docs/Web/JavaScript/EventLoop	/zh-TW/docs/Web/JavaScript/Event_loop
/zh-TW/docs/Web/JavaScript/Guide/Introduction/關於	/zh-TW/docs/Web/JavaScript/Guide/Introduction
/zh-TW/docs/Web/JavaScript/Guide/JavaScript_Overview	/zh-TW/docs/Web/JavaScript/Guide/Introduction
/zh-TW/docs/Web/JavaScript/Guide/JavaScript_概觀	/zh-TW/docs/Web/JavaScript/Guide/Introduction
/zh-TW/docs/Web/JavaScript/Guide/JavaScript_概觀（JavaScript_Overview）	/zh-TW/docs/Web/JavaScript/Guide/Introduction
/zh-TW/docs/Web/JavaScript/Guide/Obsolete_Pages	/zh-TW/docs/Web/JavaScript/Guide
/zh-TW/docs/Web/JavaScript/Guide/Values,_variables,_and_literals	/zh-TW/docs/Web/JavaScript/Guide/Grammar_and_types
/zh-TW/docs/Web/JavaScript/Guide_old	/zh-TW/docs/Web/JavaScript/Guide
/zh-TW/docs/Web/JavaScript/Guide_old/Details_of_the_Object_Model	/zh-TW/docs/Web/JavaScript/Inheritance_and_the_prototype_chain
/zh-TW/docs/Web/JavaScript/Guide_old/Functions	/zh-TW/docs/Web/JavaScript/Guide/Functions
/zh-TW/docs/Web/JavaScript/Guide_old/Grammar_and_types	/zh-TW/docs/Web/JavaScript/Guide/Grammar_and_types
/zh-TW/docs/Web/JavaScript/Guide_old/Introduction	/zh-TW/docs/Web/JavaScript/Guide/Introduction
/zh-TW/docs/Web/JavaScript/Guide_old/JavaScript_概觀	/zh-TW/docs/Web/JavaScript/Guide/Introduction
/zh-TW/docs/Web/JavaScript/Guide_old/JavaScript_概觀（JavaScript_Overview）	/zh-TW/docs/Web/JavaScript/Guide/Introduction
/zh-TW/docs/Web/JavaScript/Guide_old/Regular_Expressions	/zh-TW/docs/Web/JavaScript/Guide/Regular_expressions
/zh-TW/docs/Web/JavaScript/Introduction_to_Object-Oriented_JavaScript	/zh-TW/docs/Learn/JavaScript/Objects
/zh-TW/docs/Web/JavaScript/JavaScript_typed_arrays	/zh-TW/docs/Web/JavaScript/Guide/Typed_arrays
/zh-TW/docs/Web/JavaScript/Language_Resources	/zh-TW/docs/Web/JavaScript/JavaScript_technologies_overview
/zh-TW/docs/Web/JavaScript/Obsolete_Pages/Control_flow_and_error_handling	/zh-TW/docs/Web/JavaScript/Guide/Control_flow_and_error_handling
/zh-TW/docs/Web/JavaScript/Obsolete_Pages/Expressions_and_Operators	/zh-TW/docs/Web/JavaScript/Guide/Expressions_and_operators
/zh-TW/docs/Web/JavaScript/Obsolete_Pages/Loops_and_iteration	/zh-TW/docs/Web/JavaScript/Guide/Loops_and_iteration
/zh-TW/docs/Web/JavaScript/Obsolete_Pages/Obsolete_Pages	/zh-TW/docs/Web/JavaScript/Guide
/zh-TW/docs/Web/JavaScript/Obsolete_Pages/Obsolete_Pages/Obsolete_Pages	/zh-TW/docs/Web/JavaScript/Guide
/zh-TW/docs/Web/JavaScript/Obsolete_Pages/Obsolete_Pages/Obsolete_Pages/JavaScript_概要	/zh-TW/docs/Web/JavaScript/Guide/Introduction
/zh-TW/docs/Web/JavaScript/Obsolete_Pages/Obsolete_Pages/Obsolete_Pages/Unicode	/zh-TW/docs/Web/JavaScript/Guide/Grammar_and_types
/zh-TW/docs/Web/JavaScript/Obsolete_Pages/Obsolete_Pages/Obsolete_Pages/以類別為基礎的語言_vs._以原型為基礎的語言	/zh-TW/docs/Web/JavaScript/Inheritance_and_the_prototype_chain
/zh-TW/docs/Web/JavaScript/Obsolete_Pages/Obsolete_Pages/Obsolete_Pages/值	/zh-TW/docs/Web/JavaScript/Guide/Grammar_and_types
/zh-TW/docs/Web/JavaScript/Obsolete_Pages/Obsolete_Pages/Obsolete_Pages/再談屬性的繼承	/zh-TW/docs/Web/JavaScript/Inheritance_and_the_prototype_chain
/zh-TW/docs/Web/JavaScript/Obsolete_Pages/Obsolete_Pages/Obsolete_Pages/再談屬性的繼承/實體關係的確定	/zh-TW/docs/Web/JavaScript/Inheritance_and_the_prototype_chain
/zh-TW/docs/Web/JavaScript/Obsolete_Pages/Obsolete_Pages/Obsolete_Pages/再談屬性的繼承/局域值和繼承值	/zh-TW/docs/Web/JavaScript/Inheritance_and_the_prototype_chain
/zh-TW/docs/Web/JavaScript/Obsolete_Pages/Obsolete_Pages/Obsolete_Pages/再談屬性的繼承/建構子中的全域資訊	/zh-TW/docs/Web/JavaScript/Inheritance_and_the_prototype_chain
/zh-TW/docs/Web/JavaScript/Obsolete_Pages/Obsolete_Pages/Obsolete_Pages/再談屬性的繼承/沒有多重繼承	/zh-TW/docs/Web/JavaScript/Inheritance_and_the_prototype_chain
/zh-TW/docs/Web/JavaScript/Obsolete_Pages/Obsolete_Pages/Obsolete_Pages/函數的呼叫	/zh-TW/docs/Web/JavaScript/Guide/Functions
/zh-TW/docs/Web/JavaScript/Obsolete_Pages/Obsolete_Pages/Obsolete_Pages/函數的定義	/zh-TW/docs/Web/JavaScript/Guide/Functions
/zh-TW/docs/Web/JavaScript/Obsolete_Pages/Obsolete_Pages/Obsolete_Pages/區塊文法	/zh-TW/docs/Web/JavaScript/Guide/Control_flow_and_error_handling
/zh-TW/docs/Web/JavaScript/Obsolete_Pages/Obsolete_Pages/Obsolete_Pages/區塊語法	/zh-TW/docs/Web/JavaScript/Guide/Control_flow_and_error_handling
/zh-TW/docs/Web/JavaScript/Obsolete_Pages/Obsolete_Pages/Obsolete_Pages/字面表達	/zh-TW/docs/Web/JavaScript/Guide/Grammar_and_types
/zh-TW/docs/Web/JavaScript/Obsolete_Pages/Obsolete_Pages/Obsolete_Pages/常數	/zh-TW/docs/Web/JavaScript/Guide/Grammar_and_types
/zh-TW/docs/Web/JavaScript/Obsolete_Pages/Obsolete_Pages/Obsolete_Pages/循環語法	/zh-TW/docs/Web/JavaScript/Guide/Control_flow_and_error_handling
/zh-TW/docs/Web/JavaScript/Obsolete_Pages/Obsolete_Pages/Obsolete_Pages/條件文法	/zh-TW/docs/Web/JavaScript/Guide/Control_flow_and_error_handling
/zh-TW/docs/Web/JavaScript/Obsolete_Pages/Obsolete_Pages/Obsolete_Pages/條件語法	/zh-TW/docs/Web/JavaScript/Guide/Control_flow_and_error_handling
/zh-TW/docs/Web/JavaScript/Obsolete_Pages/Obsolete_Pages/Obsolete_Pages/正則表達式模式的編寫	/zh-TW/docs/Web/JavaScript/Guide/Regular_expressions
/zh-TW/docs/Web/JavaScript/Obsolete_Pages/Obsolete_Pages/Obsolete_Pages/正則表達式的建立	/zh-TW/docs/Web/JavaScript/Guide/Regular_expressions
/zh-TW/docs/Web/JavaScript/Obsolete_Pages/Obsolete_Pages/Obsolete_Pages/正則表達式的運用	/zh-TW/docs/Web/JavaScript/Guide/Regular_expressions
/zh-TW/docs/Web/JavaScript/Obsolete_Pages/Obsolete_Pages/Obsolete_Pages/正則表達式的運用/使用標誌的進階搜尋	/zh-TW/docs/Web/JavaScript/Guide/Regular_expressions
/zh-TW/docs/Web/JavaScript/Obsolete_Pages/Obsolete_Pages/Obsolete_Pages/正則表達式的運用/括弧子字串的比對結果的運用	/zh-TW/docs/Web/JavaScript/Guide/Regular_expressions
/zh-TW/docs/Web/JavaScript/Obsolete_Pages/Obsolete_Pages/Obsolete_Pages/正則表達式的運用/正則表達式的範例	/zh-TW/docs/Web/JavaScript/Guide/Regular_expressions
/zh-TW/docs/Web/JavaScript/Obsolete_Pages/Obsolete_Pages/Obsolete_Pages/正規表達式模式的編寫	/zh-TW/docs/Web/JavaScript/Guide/Regular_expressions
/zh-TW/docs/Web/JavaScript/Obsolete_Pages/Obsolete_Pages/Obsolete_Pages/正規表達式的建立	/zh-TW/docs/Web/JavaScript/Guide/Regular_expressions
/zh-TW/docs/Web/JavaScript/Obsolete_Pages/Obsolete_Pages/Obsolete_Pages/正規表達式的運用	/zh-TW/docs/Web/JavaScript/Guide/Regular_expressions
/zh-TW/docs/Web/JavaScript/Obsolete_Pages/Obsolete_Pages/Obsolete_Pages/正規表達式的運用/使用標誌的進階搜尋	/zh-TW/docs/Web/JavaScript/Guide/Regular_expressions
/zh-TW/docs/Web/JavaScript/Obsolete_Pages/Obsolete_Pages/Obsolete_Pages/正規表達式的運用/括弧子字串的比對結果的運用	/zh-TW/docs/Web/JavaScript/Guide/Regular_expressions
/zh-TW/docs/Web/JavaScript/Obsolete_Pages/Obsolete_Pages/Obsolete_Pages/正規表達式的運用/正則表達式的範例	/zh-TW/docs/Web/JavaScript/Guide/Regular_expressions
/zh-TW/docs/Web/JavaScript/Obsolete_Pages/Obsolete_Pages/Obsolete_Pages/正規表達式的運用/正規表達式的範例	/zh-TW/docs/Web/JavaScript/Guide/Regular_expressions
/zh-TW/docs/Web/JavaScript/Obsolete_Pages/Obsolete_Pages/Obsolete_Pages/繼承	/zh-TW/docs/Web/JavaScript/Inheritance_and_the_prototype_chain
/zh-TW/docs/Web/JavaScript/Obsolete_Pages/Obsolete_Pages/Obsolete_Pages/職員的例子	/zh-TW/docs/Learn/JavaScript/Objects
/zh-TW/docs/Web/JavaScript/Obsolete_Pages/Obsolete_Pages/Obsolete_Pages/職員的例子/更靈活的建構子	/zh-TW/docs/Web/JavaScript/Inheritance_and_the_prototype_chain
/zh-TW/docs/Web/JavaScript/Obsolete_Pages/Obsolete_Pages/Obsolete_Pages/職員的例子/物件的屬性	/zh-TW/docs/Learn/JavaScript/Objects/Object_prototypes
/zh-TW/docs/Web/JavaScript/Obsolete_Pages/Obsolete_Pages/Obsolete_Pages/職員的例子/物件的屬性/屬性的繼承	/zh-TW/docs/Web/JavaScript/Inheritance_and_the_prototype_chain
/zh-TW/docs/Web/JavaScript/Obsolete_Pages/Obsolete_Pages/Obsolete_Pages/表達式	/zh-TW/docs/Web/JavaScript/Guide/Expressions_and_operators
/zh-TW/docs/Web/JavaScript/Obsolete_Pages/Obsolete_Pages/Obsolete_Pages/註解	/zh-TW/docs/Web/JavaScript/Guide/Control_flow_and_error_handling
/zh-TW/docs/Web/JavaScript/Obsolete_Pages/Obsolete_Pages/Obsolete_Pages/變數	/zh-TW/docs/Web/JavaScript/Guide/Grammar_and_types
/zh-TW/docs/Web/JavaScript/Obsolete_Pages/Obsolete_Pages/Obsolete_Pages/運算子	/zh-TW/docs/Web/JavaScript/Guide/Expressions_and_operators
/zh-TW/docs/Web/JavaScript/Obsolete_Pages/Obsolete_Pages/Obsolete_Pages/運算子/代入運算子	/zh-TW/docs/Web/JavaScript/Guide/Expressions_and_operators
/zh-TW/docs/Web/JavaScript/Obsolete_Pages/Obsolete_Pages/Obsolete_Pages/運算子/位元運算子	/zh-TW/docs/Web/JavaScript/Guide/Expressions_and_operators
/zh-TW/docs/Web/JavaScript/Obsolete_Pages/Obsolete_Pages/Obsolete_Pages/運算子/字串運算子	/zh-TW/docs/Web/JavaScript/Guide/Expressions_and_operators
/zh-TW/docs/Web/JavaScript/Obsolete_Pages/Obsolete_Pages/Obsolete_Pages/運算子/特殊運算子	/zh-TW/docs/Web/JavaScript/Guide/Expressions_and_operators
/zh-TW/docs/Web/JavaScript/Obsolete_Pages/Obsolete_Pages/Obsolete_Pages/運算子/算術運算子	/zh-TW/docs/Web/JavaScript/Guide/Expressions_and_operators
/zh-TW/docs/Web/JavaScript/Obsolete_Pages/Obsolete_Pages/Obsolete_Pages/運算子/邏輯運算子	/zh-TW/docs/Web/JavaScript/Guide/Expressions_and_operators
/zh-TW/docs/Web/JavaScript/Obsolete_Pages/Obsolete_Pages/Obsolete_Pages/閉包的運用	/zh-TW/docs/Web/JavaScript/Closures
/zh-TW/docs/Web/JavaScript/Obsolete_Pages/Obsolete_Pages/Obsolete_Pages/關於	/zh-TW/docs/Web/JavaScript/Guide/Introduction
/zh-TW/docs/Web/JavaScript/Obsolete_Pages/Obsolete_Pages/Obsolete_Pages/陣列的運用	/zh-TW/docs/Web/JavaScript/Guide
/zh-TW/docs/Web/JavaScript/Obsolete_Pages/Obsolete_Pages/Obsolete_Pages/預先定義的函數	/zh-TW/docs/Web/JavaScript/Guide/Functions
/zh-TW/docs/Web/JavaScript/Obsolete_Pages/Obsolete_Pages/Obsolete_Pages/預先定義的函數/Number_和_String_函數	/zh-TW/docs/Web/JavaScript/Guide/Functions
/zh-TW/docs/Web/JavaScript/Obsolete_Pages/Obsolete_Pages/Obsolete_Pages/預先定義的函數/escape_和_unescape_函數	/zh-TW/docs/Web/JavaScript/Guide/Functions
/zh-TW/docs/Web/JavaScript/Obsolete_Pages/Obsolete_Pages/Obsolete_Pages/預先定義的函數/eval_函數	/zh-TW/docs/Web/JavaScript/Guide/Functions
/zh-TW/docs/Web/JavaScript/Obsolete_Pages/Obsolete_Pages/Obsolete_Pages/預先定義的函數/isFinite_函數	/zh-TW/docs/Web/JavaScript/Guide/Functions
/zh-TW/docs/Web/JavaScript/Obsolete_Pages/Obsolete_Pages/Obsolete_Pages/預先定義的函數/isNaN_函數	/zh-TW/docs/Web/JavaScript/Guide/Functions
/zh-TW/docs/Web/JavaScript/Obsolete_Pages/Obsolete_Pages/Obsolete_Pages/預先定義的核心物件	/zh-TW/docs/Web/JavaScript/Guide
/zh-TW/docs/Web/JavaScript/Reference/Global_Objects/Array/@@iterator	/zh-TW/docs/Web/JavaScript/Reference/Global_Objects/Array/Symbol.iterator
/zh-TW/docs/Web/JavaScript/Same_origin_policy_for_JavaScript	/zh-TW/docs/Web/Security/Same-origin_policy
/zh-TW/docs/Web/JavaScript/Shells	/zh-TW/docs/Web/JavaScript/JavaScript_technologies_overview
/zh-TW/docs/Web/JavaScript/Typed_arrays	/zh-TW/docs/Web/JavaScript/Guide/Typed_arrays
/zh-TW/docs/Web/JavaScript/資料結構	/zh-TW/docs/Web/JavaScript/Data_structures
/zh-TW/docs/Web/JavaScript/重新介紹_JavaScript	/zh-TW/docs/Web/JavaScript/Language_overview
/zh-TW/docs/Web/Reference	/zh-TW/docs/Web
/zh-TW/docs/Web/Reference/API	/zh-TW/docs/Web/API
/zh-TW/docs/Web/Reference/Events	/zh-TW/docs/Web/Events
/zh-TW/docs/Web/SVG/Tutorial/入门	/zh-TW/docs/Web/SVG/Tutorial/Getting_Started
/zh-TW/docs/Web/SVG/Tutorial/图案	/zh-TW/docs/Web/SVG/Tutorial/Patterns
/zh-TW/docs/Web/SVG/Tutorial/基本形状	/zh-TW/docs/Web/SVG/Tutorial/Basic_Shapes
/zh-TW/docs/Web/SVG/Tutorial/填充与边框	/zh-TW/docs/Web/SVG/Tutorial/Fills_and_Strokes
/zh-TW/docs/Web/SVG/Tutorial/渐变	/zh-TW/docs/Web/SVG/Tutorial/Gradients
/zh-TW/docs/Web/SVG/教學	/zh-TW/docs/Web/SVG/Tutorial
/zh-TW/docs/Web/性能	/zh-TW/docs/Web/Performance
/zh-TW/docs/WebAPI	/zh-TW/docs/Web/API
/zh-TW/docs/WebAPI/Battery_Status	/zh-TW/docs/Web/API/Battery_Status_API
/zh-TW/docs/WebAPI/FileHandle	/zh-TW/docs/Web/API/File_and_Directory_Entries_API
/zh-TW/docs/WebAPI/Network_Information	/zh-TW/docs/Web/API/Network_Information_API
/zh-TW/docs/WebAPI/Permissions	/zh-TW/docs/Web/API/Permissions_API
/zh-TW/docs/WebAPI/Pointer_Lock	/zh-TW/docs/Web/API/Pointer_Lock_API
/zh-TW/docs/WebAPI/Using_Light_Events	/en-US/docs/Web/API/AmbientLightSensor
/zh-TW/docs/WebAPI/Using_Web_Notifications	/zh-TW/docs/Web/API/Notifications_API/Using_the_Notifications_API
/zh-TW/docs/WebAPI/Vibration	/zh-TW/docs/Web/API/Vibration_API
/zh-TW/docs/WebSockets	/zh-TW/docs/Web/API/WebSockets_API
/zh-TW/docs/WebSockets/WebSockets_reference	/zh-TW/docs/Web/API/WebSockets_API
/zh-TW/docs/WebSockets/WebSockets_reference/CloseEvent	/zh-TW/docs/Web/API/CloseEvent
/zh-TW/docs/WebSockets/WebSockets_reference/MessageEvent	/zh-TW/docs/Web/API/MessageEvent
/zh-TW/docs/WebSockets/WebSockets_reference/WebSocket	/zh-TW/docs/Web/API/WebSocket
/zh-TW/docs/WebSockets/Writing_WebSocket_client_applications	/zh-TW/docs/Web/API/WebSockets_API/Writing_WebSocket_client_applications
/zh-TW/docs/Web_Audio_API	/zh-TW/docs/Web/API/Web_Audio_API
/zh-TW/docs/Web_development	/zh-TW/docs/Web/Guide
/zh-TW/docs/Web_development/Writing_forward-compatible_websites	/zh-TW/docs/Learn/Tools_and_testing/Cross_browser_testing/JavaScript
/zh-TW/docs/Web_開發	/zh-TW/docs/Web/Guide
/zh-TW/docs/Web_開發/Historical_artifacts_to_avoid	/zh-TW/docs/Learn/HTML/Introduction_to_HTML
/zh-TW/docs/Web_開發/Web開發入門	/zh-TW/docs/Learn
/zh-TW/docs/XHTML	/zh-TW/docs/Glossary/XHTML
/zh-TW/docs/en	/en-US/
/zh-TW/docs/zh-tw	/zh-TW/
/zh-TW/docs/新增消息來源閱讀工具	/zh-TW/docs/Mozilla/Firefox/Releases/2/Adding_feed_readers_to_Firefox
/zh-TW/docs/本地化	/zh-TW/docs/Glossary/Localization
/zh-TW/docs/自網頁添加搜尋引擎	/zh-TW/docs/Web/OpenSearch
/zh-TW/docs/製作_OpenSearch_搜尋模組	/zh-TW/docs/Web/OpenSearch
/zh-TW/docs/重新介紹_JavaScript	/zh-TW/docs/Web/JavaScript/Language_overview
/zh-TW/docs/首頁	/zh-TW/docs/Web
